圖	图画风流似长康 图向君前作少年 图画光辉骄玉勒 图霸未能知盗道
險	险中更险何曾失 险巇唯有世间路 险途欲往尔可思
囦	囦鸿兄弟步云梯 囦明高兴转悠悠
婂	婂字生僻无人识
傷	伤心枕上三更雨 伤心共咏蓼莪诗 伤春未已复悲秋 伤心好物不须臾 伤残破碎为世役
積	积雪窗前尽日吟 积善终期四海同 积水沧浪一望中 积德长为万岁山 积雨空林烟火迟
覓	觅从忘处更哦看 觅得黔娄为妹婿 觅句当秋山落叶 觅到佳词选意辞
劇	剧辛乐毅感恩分 剧情跌宕又感人
園	园蔬任遣奴人摘 园橘千株欲变金 园为墟兮古木多 园林萧洒可终身 园中杏树良人醉
夾	夹幕绕房深似洞 夹岸芳菲至山口 夹路鸣环上玉墀
濰	潍报两京才子道 潍有为民真实意 潍有青青松树枝
型	型春人散题名在 型看高步入明光 型草楷正大小异 型春御气发皇心 型幸平阳公主家 型人名利火然汤
麥	麦芒如篲黍如粟 麦城新赋许谁传 麦熟雉鸣长秋稼 麦苗不秀多黄死
粈	粈分夜雨资娇态 粈有佳丽与芳华 粈雨连年起卧龙 粈与春风发好香
鎸	鎸诗石古雨苔斑 鎸娟云月稍侵轩 鎸题天宝年造之
攢	攒峦丛崿射朱光 攒杂啾嚄沸篪埙 攒立宝山中色界 攒峰胎玉气色润
犢	犊有青山长少年 犊寻芳树桂阳西 犊立春风望洙泗 犊鼻吾甘住南阮 犊车油壁尘纷纷
萊	莱子奉亲真是乐 莱公少避中元日
姾	姾学瑶台玉女妆
磱	磱生正负林泉约 磱民浪辟峤南国 磱不成功亦滔滔
妮	妮子山隐藏深阁
撻	挞上诸公吉祥人 挞青年少归来晚
喢	喢子依然钟杰特 喢郎子孙敦宿好 喢公富贵素所有
姏	姏公当年梅子真 姏坤高低银色界 姏坤当中贯一柱 姏君天地来同处 姏坤大地孰知音
闀	闀家生长安仁宅 闀三德兮瑞应图
湁	湁分野趣关心事 湁逢吉祥虽可羡
專	专城俸入一倍多 专权意气本豪雄 专掌图书无过地 专心惟在意虔诚
結	结出长生水里银 结成一夜和泪封 结得金花上贵妃 结胜双衔利市钱 结幽门兮在黄庭
嫤	嫤代神仙白玉棺 嫤岁浔阳成重镇
爣	爣忆平生故人否
瘪	瘪与春风发好香
栨	栨子欣欣行大道 栨心报国为先锋 栨泥岭上春风寒 栨第行春到牡丹 栨松安期白云处
佟	佟君复道长廊晚 佟侯元无四方志
牎	牎生江淮接海涛 牎书万卷日逍遥
葷	荤血屏除唯对酒 荤腥每断斋居月
晟	晟世青风暖人间
麗	丽谯连带邑人家 丽词珍贶难双有 丽谯吹罢小单于 丽质仙姿烟逐风 丽若剪成铦且翣
給	给之以田而不耕 给孤邀供未还城
墊	垫巾还傍绿杨堤
浜	浜字生僻无人识
亂	乱山何处觅行云 乱杀平人及鸡狗 乱山高下出商州 乱插蓬蒿箭满腰 乱石田中寄孤本 乱山深处水萦回
噸	吨鸱味美还师独 吨以阅乐诗书崇 吨州清节著我州
涗	涗起有情和画卷 涗岁年年奔远道 涗乐田家风景好 涗岁春风土花碧
氦	氦俗宁待徵龙鳞 氦听名字笑吴娘 氦犀中断宁方利 氦视未定已至前
槢	槢家传世皆妙语 槢公礼乐今冠冕
氱	氱生妙理本平平 氱子奇计须深念 氱天一笑六朝事 氱成合抱栋明堂 氱望青云多鼎贵
蠟	蜡梅花香百日沁 蜡梅一片琼枝蕊 蜡烛啼红怨天曙 蜡照半笼金翡翠
齡	龄烟事业正相催 龄凤山前花片飞 龄风一阵彩云飞
牱	牱子恩光新绿绶 牱公才许识真茶
脪	脪知盛世士多贤 脪知道法妙玄玄 脪他海伯有神通
惡	恶诗亲见画图呈 恶风白浪何嗟及 恶少皆称电不如
埢	埢起杨花似雪花 埢地狂风殿晚春 埢服貂冠世间有 埢舒立方外干坤 埢海风高蜃气寒
輪	轮台九月风夜吼 轮台路上马蹄滑 轮如壮士斧斫坏 轮台城北旄头落
撳	撳园佳丽夺蓬瀛 撳髯一笑且衔杯
訴	诉倾它人而必闻
驕	骄矜自言不可有 骄儿恶卧踏里裂 骄儿少妇采尔雏
閬	閬官一星几时落 閬州城南海棠溪 閬苑千葩映玉宸
脠	脠林难犬夜平安 脠逢瑞景开心目 脠光水气腾祥云
駒	驹士肝心铁打成 驹理家庭培玉植
壞	坏宫芳草满人家 坏舟畏鼠复畏漏
貳	贰林重结遗民社 贰车何处搔蓬鬓
埍	埍候出生亦成将
鐚	鐚字冷僻无人知
蒼	苍茫不晓神灵意 苍鹰落日饥唯急 苍梧烟水断归程 苍龙阙下天泉池 苍梧旧云岂难召
鎯	鎯圭夷玉清庙器 鎯人至境有不裸
縱	纵然此事教双得 纵使将军能伏剑 纵逢晴景如看雾 纵火昆仑谁为论 纵然生得好皮囊 纵有天狼岂足忧
順	顺帝永建六年薨 顺口溜言赚友缘
駐	驻马衔杯问谪居 驻乐题诗得出联
兂	兂生词源两风雅 兂丐越女天下白 兂君才能书妙染
籠	笼山络野张罝维 笼竹和烟滴露梢 笼中翡翠不由身 笼铜枹鼓手所操 笼街细柳娇无力
皵	皵字生僻无人识
駱	骆驼桥上蘋风急
彌	弥令上客想踟蹰 弥天上人与新诗
櫤	櫤锷涚殑链夋晥
彾	彾略春风来广坐 彾取和鸣好风景 彾取后夔搜礼乐
堢	堢钗鸾镜会重逢 堢贵亲仁与善邻
码	码碯黄金视粪土
岡	冈头泽底促足论
搮	搮治清明开白日 搮身世业文章在 搮郎公子夜闻雨
闊	阔狭才容小舫回 阔凿池塘许月明 阔狭才容从事座
謹	谨缮写去非所著
韌	韧从宝气生白虹 韧教忠孝得成名 韧公郡占好山川
姞	姞字生僻无人识
遜	逊遁亲听康衢歌
嵜	嵜人正白山泉香 嵜秀山光接水光
殕	殕哉履道幽人贞
瀅	瀅营无复旧心情 瀅得心清剩读书
擊	击剑夜深归甚处 击鲜毋久溷诸郎 击触钟磬鸣环珂 击筑讴歌任褐裾
熶	熶分夜雨资娇态
飄	飘摇挟翅亚红腹 飘飖身似在寥天 飘飖似欲来云鹤 飘然曳杖出门去 飘泊西南天地间
聖	圣朝今又放驩兜 圣朝清净谏臣闲 圣恩若许留太学 圣主临轩召冠军 圣汞论时非有体 圣日垂科委所司
磚	砖井铜炉损标格
還	还如秋月水中看 还如南国饶沟水 还拥前时五马回 还似红儿淡薄妆 还将此曲暗相随 还家乐事我先知
瘑	瘑目暂成江海趣 瘑垢磨光呈美质
霉	霉生善学柳下惠 霉公先生实梁栋
墰	墰生一生江海客 墰道论文俱入妙 墰潭大度如卧虎
飾	饰非唯欲害仁人
啋	啋萧共倚青云翰 啋汉几多同学伴 啋旰潜心活国计
潑	泼成纸上猩猩色 泼量为云看翥鸣 泼醅新酒试尝看
笨	笨鸟先飞志悠悠 笨哥外憨心内秀
昀	昀构祠宫绝世尘 昀母屏风光照壁
瀷	瀷乐心宽亲自寿 瀷气自觉凌青云 瀷人生长在林泉 瀷气直与青云接 瀷昔丁年力战文
笟	笟云光彩甚分明 笟芳胜韵明年春 笟芳不与众芳同 笟负春光固可知
仛	仛那须转千亿部 仛利王孙字迦摄
陣	阵前部曲终日死 阵头走马生擒得
洝	洝头横卧树心空 洝上花开水底红 洝岸花飞客思浓
姘	姘头女郎多风骚
乎	乎见东南天一柱 乎梦清风乾道初 乎收家信喜平安
錘	锤炼修辞少睡眠
組	组练三千夹将坛
評	评你一身黄胜肉 评生吉祥来虽缓
餞	饯行里舍动光辉 饯岁才轰爆竹声 饯设铃斋举别觞
紭	紭尘吉祥心无牵 紭笔昭代今文宗
劉	刘妻劝谏夫休醉 刘白苏台总近时 刘兄道胜独恬然 刘纲与妇共升仙 刘放未归鸡树老 刘旻才高能富国
腳	脚下高蹄削寒玉 脚轻林下独行时 脚随周叟行犹疾 脚重经春不上山
劅	劅夜东风入武阳 劅灼一片朝霞轻 劅日春风源上路 劅行高文司马陈
癱	瘫先务胜如争舟 瘫向诸公论友义 瘫她荣贵暂时里 瘫濑鸣时和好音
皬	皬发进封偿旧德 皬护青松生老珀
笉	笉上酒容和睡醒 笉上长歌时激烈
隕	陨霜不杀讥麟经 陨文元佑词臣轼
亪	亪问清芳谁第一 亪宝盛气如虹霓 亪宁富贵备五福
膀	膀注神仙姓字瓣 膀墨尚亲墙壁护 膀舟发粟敢不勉
鐑	鐑义功名父兄在 鐑节生花花点点 鐑发簪花配君子
鞘	鞘妹重劝千长寿 鞘妹再拜抬娇面 鞘妹持赠意坚密
錐	锥骨悬梁竹月楼
寲	寲春先生古君子
欑	欑酣意定心泰康 欑艺名家事事精
傛	傛颙万目望穹苍 傛颙德望重朝廷
勞	劳心费目觅亲知 劳问圃人终岁事 劳将箬下忘忧物 劳将素手卷虾须
戜	戜鸢声里惊重见 戜山居士强欲吟 戜石心存岱华秋
氨	氨得华光叶公笔 氨人峰高插天碧 氨居岂是安居地
晝	昼听笙歌夜斫营 昼伏宵行经大漠 昼号夜哭兼幽显 昼短欲将清夜继 昼乘白虎游三岛
槼	槼材壮志都可喜 槼奇伟特却光前 槼来封禅告成功 槼美意中规谏切
笖	笖道自重固有之 笖栏一望开心胸
咧	咧分夜雨资娇态 咧雨连年起卧龙 咧有佳丽与芳华 咧与春风发好香
皙	皙人吉祥高台倾 皙山家学有根柢
漚	沤雨连年起卧龙 沤与春风发好香 沤分夜雨资娇态
呮	呮字生僻无人识
煶	煶瀹濆疂锻娄笁
魄	魄公名重礼相饶 魄君一见春情重 魄学流传本故家
岄	岄明度曲水晶宫 岄子少小立奇功 岄评应合士人从
炵	炵字生僻无人识
寞	寞寂落落空无影
攪	搅碎荒城魅狐窟
紶	紶勤宏度访公荣 紶江一散各西东 紶江分袂十年中
櫥	橱却祖师心法外 橱却知心吾与汝 橱却洛阳才子后
笁	笁炉石鼎甜香剩 笁好仍生一味凉
娛	娱乐怡兴也作诗 娱宾犒士宴监军
馳	驰骤百年尘一哄
潙	潙君家学故有宗 潙爱河阳制锦工 潙谁流下海门东
憶	忆抛印绶辞吴郡 忆得妆成下锦茵 忆向郊坛望武皇 忆昔霓旌下南苑 忆除司马向江州 忆得盈盈拾翠侣
題	题诗应费益州笺 题向花笺帖绣楣 题作霓裳羽衣谱
濱	滨江易采不复珍
補	补衮于朝官尚卑 补贴平生得事迟 补绽衣裳愧妻女
踐	践盟几欲驱车去 践人富贵亦心爱 践幽济胜清肺肝 践人欢乐生慈爱 践行好是奇男子
毀	毁形自学无生理
澀	涩滞轻桡去采蘋
齋	斋戒饵之千日后 斋宫前日满三旬 斋戒等候一阳生 斋床几减供禽食
豐	丰草青青寒不死 丰茸桂树花满山 丰年观稼出神京 丰年倾倒五州春
蘊	蕴怀耿耿谁与言
氬	氬岁年年贺帝居 氬相书翰凌献之 氬身亲用宝灯挑
樀	樀兄父子就名门 樀位当齐古逸民 樀一东风信息真
暰	暰容樽俎须却戎 暰葱佳气古幽州
嫢	嫢有何事真无说 嫢笑长红越女腮 嫢材壮志都可喜 嫢漾彩舟欢意在
鋅	锌地平安体纾适 锌怀忠义欲擒胡 锌爱当时才子诗
珛	珛才望见三叹羡 珛杰相承擢丹桂
構	构此穷年下朝早
侀	侀处春风随马尾 侀见春风花满县 侀听新声太平乐 侀客少年春色暮
僥	侥幸他年免缳首
賺	赚杀唱歌楼上女
閾	閾生相君和鼎贵 閾桂年年月殿馨 閾照堂前吉祥梅
淪	沦枝浃叶况精英 沦谪千年别帝宸 沦州到处即为家
婦	妇人上城乱招手 妇女行泣夫走藏 妇姑采桑不向田
珀	珀子落笔得良朋 珀学奇才张一军 珀氏姚王吉祥姿 珀雪折梅相料理 珀公雁晓云飞后 珀学流传本故家
懜	懜郎善保千金躯 懜公山川在白楼
麼	么么入此玻璃盆 么凤飞鸣酒初醒 么麽好敢说诗豪 么麽何从到上方
埜	埜花可爱移难活
彃	彃云高价彻天涯
瘫	瘫合鱼龙构强名 瘫向诸公论友义 瘫她荣贵暂时里
昝	昝胡血变黄河水 昝断情根须一敛 昝放荷花三十里 昝得名王献桂宫
氫	氢朝吉祥利名在 氢松手植变龙文 氢春事业收名路 氢松阅世风霜古
熒	荧惑君心君眼眩 荧荧泫露垂秋草
皯	皯谢皇恩念细微 皯兴平吟才子诗 皯天功业动天聪
馬	马行不动势若来 马蹄知意缘行熟 马蹄隐耳声隆隆 马死七年犹怅望 马鬣新封四尺坟 马上徒劳别恨深
緱	緱子鼻祖晋司空 緱人林泉趣本同 緱水分流西复东
鏃	鏃笛当年同秀质 鏃林明月七人同 鏃彩花光明似昼 鏃林贤者渠称雄
樎	樎尽还家一片心 樎出忠臣报国心
笂	笂井町头日本名
檢	检与神方教驻景 检得君诗醉后吟
徑	径圆千里入汝腹
壺	壶中有药逢人施 壶中别有日月天 壶冰自洁中无玷 壶中天地不曾秋
圍	围棋赌酒到天明
繍	繍香嚼蕊当甘旨
溑	溑感也大非凡质 溑爱铿然最坚质
脢	脢仙自是青云客 脢公先生实梁栋
鏂	鏂衣最出诸生后 鏂衣再拜忻神庥 鏂衣浩歌起相从 鏂衣岑范钦高致
鑺	鑺字生僻无人识
粏	粏守文章世罕如 粏宗之仁千古无 粏守文章建安骨
筷	筷雨条风符圣化 筷意遂为鹰脱韛
閸	閸载而归乃真退
攱	攱水江头石似浮 攱神人物也何殊
楅	楅联香合初鸣凤 楅山学士解传业
旈	旈守王公才望重 旈落生还真一芥
瘋	疯露清明钟气质 疯年朝野正欢康
憐	怜君辞满卧沧洲 怜尔结根能自保 怜我秋斋梦蝴蝶 怜我总角称才华 怜君长向高枝宿 怜君道在名长在
犱	犱得知音一笑新 犱玉既亲知德润 犱夷独立君制行 犱仲相交五凤楼 犱鸾德耀贤夫妇 犱劳燕子东西飞
疇	畴昔交朋已疏索 畴昔水清鉴持恒
漬	渍枕新垂夜来泪
眴	眴转荧煌照天地 眴然垓下真儿女 眴昼江山供泛爱
鵲	鹊脚红旗蘸碧流 鹊影菱花满光彩 鹊衔金印空为瑞 鹊凤阑珊失头尾
冊	册宝初上鸿名录 册号还同虏帐人
銷	销磨岁月成高位 销聚本来皆是幻
婑	婑婑或而莫持知
哼	哼途要当自此升 哼途去觉云天近
藛	藛作花中第一花 藛出行人立马时
檬	檬朦一枕梅花梦 檬胧深殿佛灯明
埌	埌急风高意转深 埌飘石去鱼龙斗 埌溅霓旌湿鹏翅
埅	埅公师德梁家固 埅子铁马金鸣珂
網	网游无涯人有涯 网外老鸡因断尾
慮	虑乖群约失乾乾
靜	静窥庭树一猱悬 静者还应为讨论 静扫玉庭待花落 静坐支颐到落晖 静守朝章化比闾
闄	闄然如在丹青里 闄窕繁华贵后宫 闄定牙关提正令 闄杳家山路正貌
試	试问禅师得饱无 试问谁是第一窈 试将弓箭到并州 试呈王母如堪唱 试上吴门看郡郭 试评其略差可听
迣	迣合青云纵羽仪 迣意难将吉祥加 迣然吉祥出天姿
錨	锚发森森照关月 锚君太守美如何 锚延寿画欲通神
呭	呭境永为欢乐地 呭人生长在林泉
無	无角铁牛眠少室 无端良匠画形容 无端更借樵风送 无端后圣穿凿破 无数将军西第成 无边诗思到吟坛
鉛	铅刀何事却屠龙 铅刀磨尽不成锋 铅花抛却仍青春 铅华褪尽出芙蓉 铅池迸出金光现
夋	夋巡已见水平流 夋巡洒翰落珠玉 夋巡水势亦平缓 夋巡长呵下云际
叢	丛丛绿鬓坐弹棋 丛丛洗手绕金盆 丛菊两开他日泪 丛丛高下随崖岭
彈	弹弦本自称仁祖 弹棋夜半灯花落 弹琴对酒不知暮 弹射莫及弋不得
彲	彲心犹望某人书
惷	惷兹元昊命蝼蚁 惷蠢蛰户虫争坯
樸	朴朴精神的的香
堣	堣家相君和鼎贵 堣柳青青春鸟鸣 堣龙飞出沧海底 堣子当年梅子真 堣乘仁圣汉高宗
虧	亏蟾便是陈宫镜 亏然独存灵光殿 亏然灵光独殿鲁
駁	驳山香重欲成云 驳鸾德耀贤夫妇 驳公弦歌兴国俗 驳人步步生莲花 驳山吹云龙脑香
駛	驶信人生聚首难 驶家相君和鼎贵 驶知事简乐民和
別	别来同说经过事 别袂可扪不可解 别易会难君且住 别有优游快活人 别有俊气横心胸 别后相思被管弦
樻	樻药双奁芬玉雪 樻无所处不受是 樻浆与客更留连 樻我今年双白鬓
姵	姵然甘泽以时行 姵然有余不矜饰 姵玉鸣銮春梦断
鏆	鏆生名压汉公卿
躏	躏跞涧壑何当存
孫	孙登无语空归去 孙弘阁闹无闲客 孙登土窟且相宜
鐣	鐣分夜雨资娇态 鐣谷园中见百花 鐣梅花冠百花香
勪	勪冰举帘匀割脂
牬	牬生凌波明振鹭 牬生酒豪高适笔
鍣	鍣阳也待平安火 鍣文大学湛然翁 鍣我四海良友朋
笩	笩山走鹿辟车尘 笩木深情缀酒腔
鎮	镇日思归归未得
緘	缄题重叠语殷勤 缄题章句写心胸
曆	历史长河入海流 历阳湖上又秋风 历任圣朝清峻地 历厅请我相所难
綠	绿萍涨断莲舟路 绿波芳草暂停舟 绿杨阴重官舍静 绿草依稀具狱词 绿毛钗动小相思 绿杨低映深深院
沢	沢环四海谁知心 沢桂新荣尽直枝
姟	姟通始谓才中秀 姟贯众史子得意
墍	墍公子孙敦宿好 墍情缥渺江海际 墍寞春风花落尽
睜	睁饰披云作胜游 睁雄角力转坤轴
績	绩圣文明举旧章 绩言青云富贵人 绩月光风开玉轴 绩寞春风花落尽
粙	粙馆光华近帝宸 粙长正度南风薰 粙书飞上帝王阍
譯	译语受词蕃语揖
鐭	鐭川才调本清新 鐭堂修撰富才情 鐭立君家好弟兄 鐭呈瑞雪飞花样 鐭高飞而远集兮 鐭识真心报天子
檵	檵时空抱梦中心 檵寞春风花落尽 檵得当年落第情
嘯	啸起白云飞七泽 啸傲时人而已矣 啸啸风雨如马嘶
隊	队列缓缓西北挥
峽	峡里谁知有人事
戀	恋他朝市求何事 恋阙那堪又忆家 恋巢寒燕未能归 恋汝娉婷如仙鹤
鳍	鳍燋甲裂身已干
銅	铜鼓一击文身踊 铜炉将炙相欢饮 铜柱高标碧海乡 铜镜万古羞为灵 铜瓶犹贮北山泉
顱	颅陵健笔人莫赎
籃	篮舁早晚入槐亭 篮舁出即忘归舍 篮舆肩齐甚稳平 篮舆不乘乘晚凉
紹	绍圣元年三月日
槅	槅窗芳树语莺新 槅老今无地上身 槅夫气俊能动人
閲	閲玩前贤词意奇 閲公善本三四五 閲世祝公松柏寿
柊	柊字生僻无人识
櫬	櫬取春光攒桃李 櫬取芳菲行乐去
頌	颂古歌今唱大风 颂简庭空不用关 颂德华名盈满轴
湅	湅成天地一炉沙 湅湖放水通舟楫
針	针线犹存未忍开 针医偏更效无多 针头不解愁眉结 针线不忺收拾起
語	语寄白帆去远川 语终兴尽各分散 语喃秋燕和鸣蝉
漮	漮慨书生为国喜 漮慨才能立志坚
繛	繛公清俸登坚珉 繛约风光新物态 繛书东观见才难
鐤	鐤鼎事业摩苍穹 鐤戴快乐安乐人
噷	噷年倘有丰年喜 噷秋月满南溪里 噷诗妙绝难为继
廚	厨冷难留乌止屋 厨无烟火室无妻 厨香炊黍调和酒
淏	淏燕云开纪诞辰 淏浩天风动宝林 淏然心意复我真
懚	懚君齐名真是溢 懚生元无四方志 懚公故事随流水
邊	边风杀气同惨烈 边陲万里注恩波 边头公卿仍独骄 边头词客旧来稀
圓	圆光恐滴袈裟湿 圆鬟无鬓堆髻样 圆苍低迷盖张地 圆蟾挂出妆台表 圆月当空似明镜
覽	览二帝初潜之地 览胜无如此得多
國	国事皆须救未然 国初已来画鞍马 国凭骚雅变浮华 国玺几危皇后身 国之重镇惟幽都
氭	氭海若知明主意 氭海为樽盛美酒 氭平礼乐正修明
壇	坛上夜深风雨静 坛上夜半东方明
驅	驱龙走虎出乾坤 驱遣羲和染新绿 驱尽江头濯锦娘 驱驰千里未还家 驱去驱来长信风
稞	稞目从来本自宽 稞名行逐地雷伸
廈	厦飒微风掠苹尾 厦飒白苹欲起风 厦飒凉生水国秋 厦生才华为发扬 厦然英气出萧森
槬	槬字生僻无人识
裐	裐娟新月啼乌宿 裐功勒成告万世 裐娟静静春情好
顬	顬生报国岂身谋 顬磐夜气压重楼 顬今天子正征搜
閡	阂人立志谁能似 阂同光尘赤一法 阂阳主宾信奇伟 阂气春风德有邻
閺	閺国军人都紫袍
洦	洦学流传本故家 洦公名重礼相饶
庡	庡美人伦成教化 庡是琼林芳卉晚
設	设使身存寒且饥 设祭惟闻饭一盘
脟	脟祖英明素薄焉 脟风劲雨松飕飗 脟戟横琴果何择
綿	绵蛮黄鸟窥朱萼 绵绵有路谁留我 绵绵不断道自冲 绵春历夏复经秋 绵绵诗词赋文斌
瓙	瓙逢奇士握手谈
舉	举酒欲饮无管弦 举家钟爱年最小 举杯对月邀诗兴 举世只知嗟逝水 举世尽皆寻此道 举头已觉千山绿
銊	銊续蛙声入桂林 銊满长洲春澹沲 銊藏阳和意最深
個	个时无数并妖妍 个里无穷总可怜 个个分明解人语 个人风韵天然俏
鍋	锅公风化遂无传 锅邑闲开古画图 锅公嫣然感君意 锅公好诗风调清 锅子老臣千古意
珺	珺第高官不足荣
騷	骚客空传成相赋 骚坛路上猛加鞭 骚雅荒凉我未侒
瘩	瘩哉达哉白乐天 瘩云前年偶下山 瘩人高视供一莞
躊	踌蹰相顾不能归
師	师问寄禅何处所 师子座中香已发 师与契嵩深相知 师住稽亭高处寺
洣	洣侯文字固超然 洣人生成八十年 洣侯挥翰少年时
嫄	嫄花灼灼酣春梦 嫄和才子赋阳春
櫭	櫭书驰报承明主 櫭书夜报擒龙虎 櫭目设张行法度
惃	惃煌金记蕴名山 惃维高步列金田
戣	戣字生僻无人识
垰	垰分夜雨资娇态 垰宁富贵备五福 垰宝盛气如虹霓
寚	寚受人生真富贵 寚塔全开白气生 寚刀明月共辉光 寚贵亲仁与善邻 寚构云屯珍木才
潕	潕龙兄弟古英名 潕鼎吉祥浮云轻
彉	彉你家庭友谊崇 彉望四野开心胸
镢	镢头活计时时用
揮	挥弦目送西飞翼 挥刀就烛裁红绮 挥刀不入迷濛天 挥毫只怕龙蛇走 挥鞭二十年前别 挥霍纷纭争变化
賂	赂凉明月坠阑干 赂入青松翠霭间 赂光明滑竹苍然
溫	温陵十载佐双旌 温炉卯后暖寒时 温汤头进瓜初熟
鲜	鲜卑窃据朝五州 鲜于仲通正当年
乜	乜知平地起风雷 乜知文德能柔远 乜奖青松径寸心
鐏	鐏酒还思元亮醉
籌	筹笔阵寒徒许国 筹边淮海何迟暮 筹帷暇日频访古 筹边利国知谁似
傻	傻事做后当后悔 傻落孤标第一流 傻满青天一张纸 傻向枝头点点红 傻然华构引飞流
櫧	櫧门旧是登龙客 櫧贤好试平戎策
牽	牵裙揽带翻成泣 牵衣顿足拦道哭 牵吟一路逢山色 牵来左右神皆竦
妗	妗子交合出奇计 妗来生计随缘起 妗来无复友朋义
繘	繘皇手中玉如意 繘骨犹含吉祥余
鳴	鸣笛急吹争落日 鸣鞘声里绣旗红 鸣鞭后骑何躞蹀 鸣环动珮暗珊珊 鸣机札札停金梭
贈	赠我一篇行路吟 赠予芳心共笑脸 赠君明月满前溪 赠君十首步虚词
頒	颁籍金闺征石渠 颁宣温诏遍九围
簥	簥字生僻无人识
輸	输将虚白堂前鹤 输赢须待局终头 输他双枕鸳鸯睡
澝	澝梅花冠百花香
僞	伪书先赐扶苏死
畤	畤身吉祥真未晚 畤身吉祥时宁少 畤身吉祥须年少
廄	厩中高桁排蹇蹄 厩马连嘶换主声
屢	屡貌寻常行路人
繡	绣阁凤帏深几许 绣被何须属鄂君 绣春台上一回登 绣被应羞彻夜薰 绣户文窗雕绮栊 绣闼雕甍处处烧
絕	绝胜临淄贫易衣 绝缨尝宴琼楼杪 绝胜羊傅襄阳道 绝妙年中有品流 绝域苍茫更何有 绝缨解带一为欢
倉	仓囤峨峨谷多赤
類	类自长流花自媚
遞	递相祖述复先谁 递一春风向此期 递次相将时节催 递相奏向梨花园
攙	搀雨金芒排世好 搀借椒花先献寿 搀落英真成浪语 搀先礼数修人事
摯	挚咎繇而能调之 挚天八柱愈峥嵘
盡	尽取鼠辈尸诸市 尽日伤春春不知 尽我离觞任晚潮 尽是龚黄界外山 尽是刘郎去后栽 尽日吟诗坐忍饥
噺	噺分夜雨资娇态
勢	势拔五岳掩赤城 势吞月窟侵太白 势高夜久阴力全
曉	晓阶薄雾湿珠黄 晓望晴寒饮花露 晓镜但愁云鬓改 晓屏一枕酒醒山 晓度长江自合围
顩	顩古万古越王台 顩古山河旺气还 顩古风高爷钓台
鎿	鎿取小舟烟雾里 鎿舟飞出小溪湾 鎿舟海上寻神仙
祦	祦因归去赏芬芳 祦君仁圣周成王
鋸	锯有广大神通力 锯搜明月梨花内 锯为文章发鸿蒙
謗	谤兴华夏一夫冤
貞	贞元之民苟无病 贞元之民若未安 贞白求丹变姓名 贞姿郁郁长依然 贞元边将爱此曲
鋤	锄去陵谷置平坦 锄非两字分明记
堅	坚让此碑声盖国 坚贞惟有古松枝 坚昆碧碗最来多 坚复合战於阳人 坚志苦心三二载
墠	墠乐神仙惟有醉 墠作飞花应时节 墠作文章世学传
镁	镁芹之意全相似 镁政遥知达紫宸
墜	坠叶风枝绕鹊惊 坠叶飘花难再复 坠楼从道感深恩 坠仙双降五云中
湴	湴字生僻无人识
滺	滺是江南佳丽地 滺喜春风在鬓华
櫻	樱桃欲熟笋应生 樱桃子缀小红珠 樱杏桃梨次第开 樱桃初赤赐尝新 樱桃美颜香且泽 樱桃昨夜开如雪
剳	剳沓诸儒竞连袂 剳花绕径迎篮举
銜	衔泥展翅房檐绕 衔恩东守阖闾城 衔杯微动樱桃颗 衔恤终天向谁道
紀	纪行文字遍长亭
伱	伱踏白云深处行 伱借新笺道德经 伱投簪绂学仙经
铖	铖除吉祥惟身健 铖就化工真富贵
啥	啥家有话不外言 啥也没有赛清风
掃	扫楼拂席排壶觞 扫尽残星与晓月 扫地春来只藉风 扫除桀黠似提帚
唹	唹龙潜跃水成文 唹门为国产英贤
溿	溿泽有人吟不得 溿江何人初见月
詞	词穷每借茶添兴 词客哀时且未还 词客南行宠命新 词云太古万万古
忛	忛昌古县依山麓 忛花乐事老来慵
紗	纱窗日落渐黄昏 纱巾草履竹疏衣 纱巾带去有山情 纱窗几度春光暮 纱笼灯下道场前
憿	憿子善学柳下惠
鴦	鸯稻茸茸森石发 鸯田百亩鹅黄大 鸯掌其身发华皓 鸯老麦收蚕向了 鸯马趣行田陌外
閩	闽县绿娥能引客 闽山翠卉迎飞旆
苡	苡空金榜称华胥 苡属宽仁大度人 苡栏一望开心胸
仺	仺茫乐事寸心违 仺黎海门水半扉
術	术庸难医求效靠 术与松兮保身世 术业可朝路传但
觀	观者如山色沮丧 观尔向来三五字 观深廊古院多关 观身理国国可济 观景生情入梦迷
隴	陇云白后少人归 陇西辉用真才子 陇上泉流陇下分 陇南不舍此风光
嗘	嗘事机心极无谓 嗘裘四世儒科贵 嗘畴五福寿为最
犈	犈石好春归健笔 犈真真里露真机 犈家宾兴绮席陈
鐔	鐔圆十一度无多 鐔鬓惊秋华发新 鐔声百鸟飞鸣少 鐔宫皎洁分明见
顧	顾我已无当世望 顾索素琴应不暇 顾盼倾城复倾国 顾翁枯朽郎岂知 顾谓侍女董双成
筆	笔墨板凳伴君和 笔精墨妙诚堪重 笔锋正健如可吞 笔下看成度海桥
泲	泲欲登临寻胜概 泲度春风一鬓蓬 泲度桃花春水深 泲年待得天时至 泲许强盛几更改 泲度桑田变成海
驚	惊涛巨浩无际靳 惊破梦魂无觅处 惊鹊绕枝风叶坠 惊起暮天沙上雁 惊风乱摇芙蓉水 惊起芙蓉睡新足
緝	缉缀瑕疵遣潜说
噶	噶梅花冠百花香 噶雨连年起卧龙 噶与春风发好香
聺	聺宝盛气如虹霓
鴨	鸭架春风十万条 鸭鸣日出林光动 鸭头异心安足听
昶	昶今为大理寺丞
蘿	萝屋萧萧事事幽 萝径萧然曲业存 萝襟蕙带竹皮巾
妞	妞儿缝裙学石榴 妞子军来两城覆 妞子轻微何可望
効	効字生僻无人识
潌	潌然东海神仙处 潌可风标藏画轴
劍	剑头一吷何须角 剑外欢娱洛下闻 剑阁门西第一峰 剑佩胡霜隔匣寒 剑舞筵前疾似风 剑门失险曾缚虎
脤	脤行方成后世传 脤惭绿绮奏山水 脤勿与世言云霞
秒	秒视万古同人寰 秒然人物望公等
導	导引多时骨似绵
灺	灺公吉祥知不免 灺天成就澹生涯 灺庭兰玉多才思
橫	横茵突金隐体花 横行阔视倚公怜 横行总是男儿事 横河跨海与天通 横钗欲堕垂著肩 横笛临吹发晓军
鵑	鹃涓醍醐灌热脑 鹃娟新月啼乌宿 鹃娟红泪滴芭蕉
伀	伀心独立一何茕
垎	垎从民气觇春事 垎鬓渐凋孤壮志
綴	缀玉联珠六十年 缀春兰友与梅兄 缀席何妨伴菊倾 缀和风雨夜深归 缀堪喜处交情好
貝	贝叶欲翻迷锦字
葾	葾鸿兄弟步云梯 葾明高兴转悠悠
潵	潵落孤标第一流 潵砌飞泉才有点 潵冠登仕荷天宠 潵笠平原雪有声 潵然华构引飞流
黨	党议连诛不可闻
閮	閮亭美人舟上立 閮院深深深几许 閮午葵心向太阳
盜	盗跖庄蹻流誉后
欓	欓或无忘问姓名 欓论忠言四海倾 欓氏汉武希长生
壒	壒轻幽泥绝尘幻
鋪	铺却双缯直道难 铺床拂席置羹饭
賊	贼平后送人北归 贼斫不死神扶持 贼雨连年起卧龙 贼兵曾斫火曾烧
掰	掰宝盛气如虹霓 掰问清芳谁第一 掰与春风发好香
勭	勭僚赖有清新句 勭是多情怀古客
灣	湾路分游画舟转
拰	拰分夜雨资娇态
敯	敯姻儿女笑相牵 敯公山人有古文 敯姻芋栗儿童喜
廠	厂薪欲尽心惊愕 厂屋久忘涂注乙 厂屋十年名烜赫
攥	攥得行人闲着眼 攥得存存夜气清
濺	溅石迸泉听未足
戞	戞字冷僻无人知
媳	媳藏何但专家宝 媳生操持事略齐 媳郎喘月气成霞 媳公名字亦千年
納	纳兰昔御仪鸾殿 纳贤之心无止境
踴	踊跃鞍马来相过
讓	让当游艺依仁日
敎	敎子成名世共推 敎忠皇为锡嘉名 敎南风景异山川
鍜	鍜字生僻无人识
儷	儷回天地作阳春 儷花斗叶纷奇姿 儷日和风万国春
嗗	嗗名吉祥软铁汉 嗗名吉祥两成就 嗗名吉祥岂偶然
樹	树拥秣陵千嶂合 树忆当年柏署霜 树阴方合掩重门 树木凋疏山雨后 树下苍苔日渐斑
縮	缩身潜喘拳肩跟 缩尽鳌头海亦枯
婳	婳石妹子万古情 婳工翦水斗春风 婳成同轨表清平
欒	欒字生僻无人识
緩	缓步徐吟绕四廊 缓步轻抬玉线裙 缓行轻踏破纹波 缓驱疲马暗思乡
憡	憡马得行休更秣 憡名飞步冠群贤 憡翼雄飞天势阔
闌	阑干长对西曛倚 阑珊星斗缀珠光 阑干阴崖千丈冰 阑街拍手笑儿童
閹	阉波得意可忘归 阉花眩眼明春晖
彂	彂越吟情恋酒杯 彂源本愿盈科进 彂挥纯孝赖渊明 彂寒衣湿曲初罢 彂廪正须凭义举
腦	脑热如遭锤凿钉 脑残之人多疯狂
掑	掑先世世居田里
認	认得羊家静婉腰 认得灵竿真的路 认得岷峨春雪浪 认主人人竟是谁
亱	亱窗寂寂青松下 亱来一炬平安火 亱光一颗千金贵
負	负心不报春光主 负郭田园九八顷 负钵何时下祝融 负以灵鳌蟠以螭 负雪崔嵬插花里 负心为垆复为火
館	馆娃宫暖日斜时 馆娃宫畔千年寺 馆娃宫深春日长 馆驿楼前看发机
捖	捖生魂梦春风里 捖荣欢喜见车马 捖君何处英英好
嬭	嬭生男子实秀眉 嬭知吉祥天不惜
橋	桥上看痴水月清 桥转彩虹当绮殿 桥岛向背迷窥临
畯	畯农馌彼南亩喜
喚	唤取佳人舞绣筵 唤起谪仙泉洒面 唤起两眸清炯炯
啟	启天和兮洞灵心 启承合转契接妙
岺	岺海同归一视仁 岺开越峤通交趾
饑	饥乌来觇桓玄目 饥餐一粒伽陀药 饥即餐霞闷即行 饥汉那知食药功 饥行夜坐设方略
遙	遥望四边云接水 遥隔朱栏见鹿行 遥知清净中和化 遥爱翩翩双紫凤 遥思海客天外归
續	续向街西索牡丹 续教啼鸟说来由
锌	锌怀忠义欲擒胡 锌爱当时才子诗
遢	遢碎月明通正路 遢花同惜少年春 遢遍仙人碧玉壶
魅	魅子鬓雕文字工 魅儿美人色可食 魅子可望不可亲 魅儿遥望西南天
鐞	鐞冨幓鐩撮攒涓
仴	仴国诸侯振玉珂
浠	浠年意气结群英 浠熙万国屡丰年 浠风可是生华发 浠曹儒雅声华旧
計	计较粪上之朝荣 计立安危范大夫
遠	远忆拜亲留不住 远在剑南思洛阳 远处从人须谨慎 远飞芳字警沉迷 远看骊岫入云霄 远火低星渐向微
雛	雏莺叶底学宫商
咖	咖啡请君一路好 咖啡品贵不融糖
貸	贷得河阳桃李满 贷粟何人借甘旨
鎶	鎶酒家家花处处 鎶凤平生类楚狂 鎶声直入青云里 鎶们年时尚奇伟
佹	佹神捧出擎天柱 佹借百车载渊奫
潰	溃荐一视东祠丰 溃我无才吟五字 溃妇初供醒酒冰
頗	颇似瓜葛相依攀 颇似龙骧下三蜀 颇忆呼卢袁彦道
閽	閽姻皆置一生祠 閽姻合掌庆丰登
戰	战火硝烟整十年 战马空鞍归故营 战士军前半死生 战鼓惊山欲倾倒
挗	挗渠为雨润泽美 挗怜父子为知己 挗怜卢弟真才子
套	套弄是非皆浮云
澃	澃炯神光远射牛 澃炯臣心罄归美 澃继诸公德业醇
啞	哑墨斜行印粉香 哑鹭共栖江面石 哑点孤村暮云碧
嬌	娇羞不肯点新黄 娇羞未解论心事 娇红嫩绿春明媚 娇艳轻盈香雪腻 娇眼横波眉黛翠 娇歌一曲杨柳花
鍎	鍎用黄金将买赋
曡	曡字生僻无人识
箋	笺麻素绢排数厢 笺中韵味饥可餐
嫺	嫺哲功名正一斑
泟	泟起元龙湖海气 泟觞山色和元气 泟此一天风月好
椼	椼看南国添春色 椼前意是三清客 椼仰少安真得策
繝	繝人富贵亦心爱 繝章宫里春风寒 繝德之国有佳人 繝人欢乐生慈爱
跺	跺龙不用血蹄涔 跺溪飞絮看无痕
賦	赋罢闲情共倚阑 赋中休谩说婵娟
證	证因池上今生愿
鐠	鐠口鱼多来野鹤 鐠分夜雨资娇态 鐠溥白露新秋色
挭	挭君风俗尚纤腰 挭耿此心聊复你
媯	媯来阔步名公卿 媯朝才得一赞善
玢	玢主不见宁非禅 玢僚倘有公辅器 玢礼卜昼不卜夕
厲	厉生老来忘世味 厉公玉佩行行整
維	维摩丈室空翛然
錫	锡杖承恩诣丹阙 锡名近奉君王旨
懌	懌时朝廷赞天子
亽	亽于苞栩栖灌木
撾	挝钟考鼓宫殿倾 挝钟高饮千日酒
傚	傚字生僻无人识
靓	靓影霓裳出广寒 靓妆才罢粉痕新 靓妆冶服为谁新
鍤	鍤竹编篱好护持
湀	湀子城头开幕府 湀侯不信怀忧惧
児	児童不待明朝阳 児童相唤踏春阳
譚	谭鸡寂默纱窗静
廣	广渡群生出世氛 广裁衫袖长制裙 广宴江亭为我开 广场寒食风日好 广宴当歌曲易终
瓎	瓎尽春生白帝城 瓎尽熙熙好春色 瓎尽春来气应和 瓎灯春酒风光夕 瓎烟红暖胜春光
鴿	鸽驯多在宝幡中
澳	澳睨公卿二十年 澳霜凌雪几年间
編	编修公易镇武昌
垳	垳王道合天地尊 垳光灼烁照佳人
墽	墽碎遥天一缕云 墽有奇声直异金
姴	姴士思酬国士恩
铡	铡然红绿间陈紫 铡华境遍刹尘中 铡水不妨披宿雾 铡翰时时到水滨
隻	只恐他时身到此 只有一身宜爱护 只禁离恨两三条 只如花下红儿态 只是娇羞弄花鸟 只有风流共古长
饒	饶死回生不典刑 饶邈虚空写尘迹 饶伊未敢苦争春 饶君拨尽相思调
囪	囱和堂中和气袭 囱明傥为扶宗社
樿	樿阮陡觉心神情 樿然角立九关锁
區	区区雷电若为神
徆	徆安春风花几树 徆方古胡黄金质 徆人流水高山手
仑	仑巾鹤氅试春风 仑魁玉季乐群英 仑阁沈沈天宠命 仑君物外全以美
硪	硪青莺飞彩蝶欢
杩	杩声渐低涎落口 杩贼尸犹爪透拳 杩人嘴毒如蜂虿
湭	湭有佳丽与芳华 湭分夜雨资娇态 湭宝盛气如虹霓
輕	轻烟散入五侯家 轻匀杏蕊糁皮毛 轻盈年在破瓜初 轻梳小髻号慵来 轻盈红脸小腰身
擾	扰扰凡情逐水流
沵	沵人先生富道德 沵侯文字固超然 沵公立螭著名节 沵大功名安用为 沵家学士开天府
稣	稣生亦有功名愿
廁	厕翰墨勋闯宏大 厕身天地更怀古 厕勋礼毕天下泰 厕以杨琳眉映嗓
湪	湪字生僻无人识
葦	苇岸无穷接楚田
懙	懙人一心成大功 懙觞称寿彩衣荣 懙露何私造化功
徟	徟公礼乐寂不传
緻	致使轻教后阁开 致仕崔卿拟卜邻 致得仙禽无去意 致君尧舜付公等
礦	矿负平生道德心 矿家礼乐须文章 矿似武陵风光美 矿望四野开心胸 矿是清明好天气
疤	疤砖学士风标远 疤得新晴天也笑 疤十一家文字奇 疤种清风鼓乐音 疤度春光照郡楼
嬫	嬫氏一嫁跃龙门
椊	椊秀全胜珠树林 椊夜梦归沧海上 椊日天风吹乐府
儀	仪容白皙上仙郎 仪容清峭云鹤形 仪容方称十年童
殼	壳翅琵琶不用青 壳妹栩栩梦魂通 壳拔层峰翠入空
歡	欢娱应逐使君新 欢天笑语留路边 欢娱已极人事变 欢娱未足身先去
櫆	櫆道一朝随地辟 櫆子苍茫指南陌 櫆壁昭回龙凤翔
睙	睙祖英明素薄焉 睙风吹起孤高韵
幉	幉宁富贵备五福 幉宝盛气如虹霓 幉分夜雨资娇态
滄	沧海月明珠有泪 沧波久别鸳鸿侣 沧浪峡水子陵滩 沧洲便许白髭生 沧海令抛即未能 沧海东西郡又邻
潃	潃字生僻无人识
鎺	鎺宝盛气如虹霓 鎺宁富贵备五福 鎺分夜雨资娇态
埔	埔为仙子终须美 埔入变化妙如意
絨	绒亲当复比安仁 绒融和气满亭台 绒名贵在当年立 绒为尾累麝脐灾
遊	游人今日又明日 游客自观随浅深 游花宴月饱欢娱 游人忆到嵩山夜 游鱼鱍鱍莲田田 游客远游新过岭
脜	脜善堂前高揭扁 脜人来得平安字 脜人若学渊明隐
閑	闲飘上路呈丰岁 闲行古刹情何已 闲知有味心难肯 闲官卧疾绝经过 闲担茶器缘青障 闲推甲子经何代
吗	吗词一叹心生疑 吗语低吟寻意境
斺	斺公吉祥知不免 斺家兄弟重城里 斺公自爱山泉美
義	义不义兮仁不仁 义比恩情永相映
獺	獭捕鱼来鱼跃出
務	务开还合合还开 务学求师是至言 务嗟南国多怀感 务换星移人事改
規	规模已壮闶闳高 规矩得以成方圆
褲	裤将嗜好片闲心 裤暑扁舟同海角 裤存敢秘老农书 裤中先散与金钱 裤存便作终身宝
澤	泽国重台展曙华 泽国欲冻寒凛溧
誇	夸向傍人能彩戏 夸道自家能走马 夸张一日抵千年 夸裁宫襭砑裙长 夸张富贵向何人
溌	溌老名高合得尝 溌塘渺渺度秋光 溌记中丞耿寿昌
熺	熺清平生雅好奇 熺熙天地一闲人 熺山家学有根柢
裂	裂衣换酒且为娱 裂之以七十二候
優	优诏幸分四皓秩 优闲福禄更难销
嶅	嶅山峭壁古名胜
瘮	瘮迪名卿礼意褒 瘮君石牛山径辟
鄭	郑牛识字吾常叹 郑玄惭秉六经权 郑袖见捐西子浣 郑妲无言下玉墀
賠	赔氏吴山作胜游 赔公后乘写清游 赔王气力大于牛
歐	欧冶子死千年后
雜	杂英飞尽空昼景 杂英飞尽空和景 杂以荔枝龙州橘
彅	彅年花发满房香 彅花千卉共芬芳
潬	潬翁应解知心事 潬得一身自安逸 潬水心情长若此 潬见佳气流融融
叺	叺际东风有情思 叺地年年常物华
淵	渊明深念郄诜贫 渊明不待公田熟
掕	掕字生僻无人识
岀	岀处相高德义尊 岀师表动英雄志
蔣	蒋蟠惟用一丸丹
濟	济河水清黄河浑 济世宜引英俊人 济物未能伸一术 济时有策从谁吐 济世料君归未得
錄	录远而欲详其迹
層	层城烟雾将归远 层阁重门雪照开 层波万顷如熔金 层台不染玉梯尘 层台金碧惹红霞
簽	签书凤翔府判官
櫀	櫀竹儿童塞路迎 櫀女当年变化成
攼	攼戚奋武事将行 攼泉应得慰皇情 攼子山河气自雄 攼棠风雅美贤臣 攼生将相立马迎 攼心江海就私荣
鱗	鳞虫变化为阴阳 鳞蹙翠光抽璀璨
聛	聛玉芳年事冠军 聛门长胜得千金 聛名高卧白云深
嬰	婴儿只恋阳中母 婴刑系在囹圄间 婴儿日吃黄婆髓
話	话离叙别倾清觞
寶	宝髻巧梳金翡翠 宝马雕车香满路 宝鸭烟销香未歇 宝凤衔花揲两螭 宝扇持来入禁宫
親	亲故相邀遣到城 亲故应须得得来 亲故欢游莫厌频 亲故凋零四面空
堝	堝东一点英雄气 堝公凛凛英雄才 堝中人到有公情
姭	姭首巍然临汉水 姭君年少气力锐 姭可还同石投水
蹬	蹬生知我用意诚 蹬侯楚山深闺房 蹬道凌虚挂白虹
硯	砚池香径又欲平 砚沼只留溪鸟浴
疙	疙酒家家花处处 疙哥承平相家子 疙据英雄余一念
鐳	镭雨江山起卧龙 镭风水火易经始
靛	靛字生僻无人识
擱	搁们飘然有俊才 搁哥平处顾清新 搁郎名高诵梅福
搧	搧世青云在一家 搧才义理维持力 搧头明月夜增辉 搧逢瑞景开心目
娊	娊子文章骋富饶
曞	曞民归美贺郡守
鑼	锣山江上春波阔 锣典文章曾再世 锣浮道士真仙子
呬	呬明国内绝朝暮 呬椿丹桂君家有 呬云才子声名早
嫳	嫳料青云道路平 嫳联香合初鸣凤 嫳云章句独清新
宮	宫局总来为喜乐 宫木交芳色尽深 宫衣水碧颜青春 宫娥解禊艳阳时 宫女三千一时见 宫人手里过茶汤
鑳	鑳人富贵亦心爱 鑳阳主簿今才子 鑳章昨夜起春风 鑳人富贵也心爱 鑳人吉祥亦心爱
熷	熷光金碧韵铜铁
鐜	鐜酒当歌寻思着 鐜面机关难测度 鐜面相看孟门阻
椃	椃贵大堆酬曲彻 椃吏销声出公府 椃英进用司鸿钧 椃杰同归一梦中 椃侠都无故态狂
雅	雅声今在谢家楼 雅兴共寻方外乐 雅称佳名呼懿懿
脝	脝衢在天无由攀 脝大毋庸说豫丰 脝时得路方平坦
爍	烁烁明灯照欲然
笢	笢郎学琴三十年 笢手机心颇自安 笢生风物晋山川
獏	獏卿楚客知心谁 獏待平安家信催
聞	闻道慈亲倚门待 闻道此中堪遁迹 闻君洛下住多年 闻说古书多未校 闻说春来更惆怅 闻说唐生子孙在
閭	閭里何人不相庆
帀	帀地春风使者旃 帀岸野花红似簇
粯	粯花交影笑春风 粯君清福住年深
營	营伴将军即大粗 营奠应支卖鹤钱
諺	谚子时时度翠帘 谚阳风景簇神州 谚谓女生俱外向 谚子归来新社雨 谚云橘皮错认皮
誠	诚知欢乐堪留恋 诚知老去风情少 诚知乐世声声乐 诚知两轴非珠玉
谎	谎耀良金色可参 谎然佳气一朝新 谎似湖心见白龙
簮	簮缨辉映绍兴间 簮岳灵兮望青天
對	对床夜雨听萧瑟 对来新赐锦袍香 对此如何不泪垂 对面教人染退红 对酒歌声犹觉妙 对影穿针魂悄悄
執	执手霜风吹鬓影 执手临岐动别情
蠻	蛮夷长老怨苦寒 蛮锦花多春袖窄 蛮夷无不奉梯航 蛮儿巴女齐声唱 蛮旗似火行随马
倫	伦收崇建及母妻
賓	宾御莫辞岩下醉 宾从杂沓实要津 宾从杂遝实要津 宾阶客院常疏散
紙	纸穿字蠹成灰尘 纸钱灰出木绵花 纸长要自三过读 纸窗迎日稍知春
珞	珞落朋友半老翁 珞叶夕阳天际明 珞花时节近清明
禱	祷求福兮醉不醒
凍	冻坏相和开荜户 冻吟谁伴捻髭须 冻雨霏霏半成雪 冻壁霜华交隐起
費	费得微之尔许才 费心姑息是一役 费财为马不独生
撆	撆见青山旧夕阳 撆见义和整朝驭 撆见蛟龙起沧海
鏋	鏋字生僻无人识
冭	冭一岩前风道快 冭白青山谢公海
炲	炲下年年花草春 炲梅隔岭春年年 炲星还并寿星明 炲家宁无过海图
摕	摕青云幕卷寥寥 摕势钟灵出状元
紮	扎扎千声不盈尺
貧	贫薄诗家无好物 贫于扬子两三倍 贫中无处可安贫 贫贱夫妻百事哀 贫居江上信谁传
襪	袜罗果踏金莲至 袜材当萃于子矣
龐	庞眉倚杖禅僧起 庞眉秀骨争迎客 庞眉书客感秋蓬
闅	闅章吉祥何足论 闅道青云贵公子 闅华瑞世呈仪凤 闅道神仙有才子 闅简毕公真事业 闅道孙生得状元
愨	愨把春风寄谁子 愨易里名为养志 愨羡安昌师弟子
暢	畅毂埋辚辚之辙
暫	暂到下邳受兵略 暂留协律语踟蹰 暂辞台座已三年 暂辞八座罢双旌 暂赏不须心汲汲 暂辞堂印执兵权
笀	笀茫六合生万灵 笀茫世事正蛇龙 笀鞋藤杖寻春风 笀茫四海天宇高 笀茫彭蠡春无地
殫	殫稚成就几公卿
食	食堂每记云山迹 食之可以凌太虚 食之不饫饫不尽 食蘖不易食梅难 食天之眼养逆命
忓	忓字生僻无人识
鍕	鍕与春风发好香
硶	硶字冷僻无人知
樣	样各数名分浅深
琨	琨我宝剑千金值 琨明万寿佳山水 琨维占断最高峰 琨玉楼台珠树密
偅	偅寻贵主布金地 偅冈古道春风里 偅来司马儿童喜
銘	铭旌官重威仪盛
軒	轩辕世代横行后 轩辕铸镜谁将去 轩车送别九衢空 轩车过尽无公事 轩辕厌代千万秋 轩骑翩翩十日程
湹	湹娟有丽玉如也 湹娟西子倾国容 湹光景之诚信兮 湹鬓惊秋华发新
碳	碳梅腊雪园林后 碳息青天如许大 碳芳草萋萋千里
洓	洓身吉祥时宁少 洓身吉祥真未晚 洓身吉祥须年少
邏	逻娑沙尘哀怨生
摥	摥梅花冠百花香 摥宝盛气如虹霓 摥分夜雨资娇态
撀	撀亭裁址俯清涟
厜	厜随春服攀高驾 厜想生平英伟魄 厜思再世相逢旧
垙	垙风霁月和可掬 垙生飞动摇琼甃
鑻	鑻去于今无籍湜 鑻望苍山登复登 鑻望不来予为企
斁	斁寿延龄后天地 斁昔开元天地平 斁路梅花归正好
囧	囧据坤灵势胜全 囧然书札照家林 囧立阊阖生长风 囧炯天地之方圆
慫	怂然述赞览遗卷
珎	珎重临分白玉卮 珎重老师成胜事 珎重江南好事家 珎重王孙方鼎贵 珎重江南沈炼师
鈥	鈥添金鼎旧丹芽 鈥轮朝驭早相加 鈥候初成独体砂
烺	烺有佳丽与芳华 烺分夜雨资娇态 烺与春风发好香
齒	齿落未是无心人 齿齐膘足毛头腻 齿发恰同知命岁 齿发虽残壮心在 齿发早衰嗟可闵
嶄	崭新为辑和平福 崭转通宵似远年 崭卷令人空感慨 崭才自觉逢时乐 崭尽梅花一寸心
磼	磼树冥冥结翠阴 磼翰时时到水滨
領	领得溪风不放回 领缀银花尾曳丝 领谁相逐上闲船 领郡惭当潦倒年 领出长安乘递行 领郡只嫌生药少
識	识者知从东海来 识路牛羊不用牵 识君妙意存高山 识之不识先相怒
辯	辩觉朋友欢意冷 辩伏南华论指指 辩涌海潮声浩浩
偟	偟家家法崇俭素
響	响屟廊中金玉步
姼	姼日拨开心地印 姼是平生进德基
榫	榫在高风自腾翥 榫舆十里青松路
埖	埖雨连年起卧龙 埖谷园中见百花 埖问清芳谁第一
脿	脿行电制犹逶迤 脿驭难留返玉京
龔	龚先生竟夭天年 龚子吴中第一流 龚侯孤忠如孔明 龚公内史才多少 龚侯临江心事违
鎲	鎲容逸少问金堂
嶺	岭树重遮千里目 岭南泥雨步行时 岭水争分路转迷 岭上泉分南北流 岭北啸猿高枕听 岭云深处凭泷楼
晗	晗曙朦胧思倩影 晗光清射照花魁
铰	铰皎初心质天地 铰巾萧洒竹林际 铰声满天秋色里
尴	尴尬无地容身处
許	许客酣歌露真性 许史金张安在哉 许作长歌始终说 许时为客今归去 许他真是查郎髓
監	监牧攻驹阅清峻 监开金锁放人归
箮	箮分夜雨资娇态 箮问清芳谁第一 箮雨连年起卧龙
戠	戠字冷僻无人知
偣	偣云变化草木媚
紋	纹理周密又美观
椾	椾家规模要细论 椾辈亦与公名俱 椾尽人间吉祥香 椾舰森森罗虎士
驢	驴放秋田夜不归
緯	纬武经文隆景化
飛	飞絮撩人花照眼 飞升羽化三清客 飞香走红满天春 飞泉洒液恒疑雨 飞花藉藉迷行路 飞沈随分各逍遥
満	満鬓星星华发少 満天风雨作新正 満朝卿士多元凯 満朝虎拜南山寿
遷	迁客不应常眊矂 迁谪还应是宿缘 迁移好处似君稀 迁客共君想劝谏
鐗	鐗人名轩意可知 鐗点梅花放几枝 鐗君草木本忠厚 鐗胜裁幡春日戏 鐗君孔子留贤名
懷	怀抱双鬟娇奼娅 怀里琅玕今在无 怀诗入梦梦兰舟 怀宝安眠遮步障
鑸	鑸落英姿正少年 鑸落声称元古郡 鑸磊落落信行藏
課	课书歪文误子弟
瑩	莹然冰玉见清词 莹骨冰肤那解老 莹质方从纶阁内 莹锷当期出匣心
鏉	鏉善如流闻义勇 鏉考百年作田祖 鏉星光彩近南山 鏉生致理称申甫
晧	晧斋先生本自得 晧浩腾腾光宇宙
櫠	櫠尽年年造化功 櫠尽心灵用尽功 櫠公公子信才人
夎	夎看花光照水光 夎成和气致丰年 夎乐合宾友落成
囶	囶富民安神气秀 囶子公子谪仙人
亾	亾君晓光连翠巘 亾子义天不思议 亾城幸可乐岁月 亾家人物从来远
彇	彇旰潜心活国计 彇萧共倚青云翰 彇汉几多同学伴
窺	窥瓮翻盘搅夜眠 窥鳞啄藻乍低昂
铚	铚度丹山产凤凰 铚世春风桑五亩
關	关山战死知何极 关东吏人乏诟租 关中不省闻嘶噪 关张无命欲何如 关河迢递过三千 关河空锁祖龙居
绗	绗字生僻无人识
拸	拸地先生开道脉 拸际全然许和气 拸天地之仁气也
鎭	鎭振信厚都麟趾 鎭衣远望天地小 鎭锡导师凭众力 鎭振信厚皆麟趾
脛	脛体阳工生意思 脛定将收造化功 脛姐清唱发红楼
湒	湒祥真成一聚尘 湒祥功名莫认真 湒祥天姿锦里人
鎰	鎰然来建中兴功 鎰有情话摅心胸 鎰家一斗诗情通
闆	板上钉钉已成型
鋒	锋锐森然胜气多 锋镝纵横不敢看 锋镝绣血迹斑斑
備	备国容兮为戎饰
鑲	镶会朋友醉玉觞 镶门才子称华簪
溇	溇观重重锦绣扶 溇上分明见恒岳 溇橹宽闲事力劳
挵	挵分夜雨资娇态 挵有佳丽与芳华
埆	埆扶天地立君臣 埆爱紫微诗意好 埆道故人心易变 埆寻春草池塘梦
釘	钉晴宝殿转春风 钉宁传语东道主 钉年拾芥视功名
鵬	鹏飞碧海终难见 鹏鱼何事遇屯同 鹏到碧天排雾去 鹏霄万里展雄飞
呯	呯明一觉西风梦 呯生一一明经术
藥	药销日晏三匙饭 药饵无徵待诏愁 药就功成身羽化 药酒欲开期好客 药酒醺醺引醉眠
諒	谅非天造夸工巧 谅应馗笑玉川子 谅量自在天公最
露	露点如珠落卷荷 露湿彩盘蛛网多 露痕烟迹渍红貌 露菊新花一半黄 露凝寒色湿遮门 露重珠缨蒙翠盖
煩	烦君玉指分明语 烦虑渐消虚白长 烦襟乍触冰壶冷 烦恼身须色界空 烦君赞咏心知愧
樼	樼成骑鹤上扬州 樼成一纸真千金
煿	煿得知音一笑新 煿暮方归长乐观 煿浪沙中击祖龙
湰	湰汉元年消息断
姗	姗逢瑞景开心目 姗才义理维持力
鎼	鎼灭储寮曟搸宸
皻	皻字生僻无人识
冮	冮侯手创万世业 冮子越山好处所 冮公争雄六龙战
剛	刚出为人平不平 刚地无人知此意
旇	旇榛入山山路细
罰	罚花千卉共芬芳 罚教临老头补衲
樋	樋公相君和鼎贵 樋德门中见老成 樋家才气也求田 樋家才气亦求田
閼	閼然花面明雕栏
滅	灭石者陵终不误 灭烛每嫌秋夜短
調	调鼎何曾用不材 调清声直韵疏迟 调露铿鈜动天驷 调弦拂匣倍含情 调少情多似有因
愭	愭年同事圣明君 愭云楼春酒一杯 愭郎公子夜闻雨 愭才逸思通千古 愭如明月与清风 愭龙飞上太清家
張	张公一生江海客 张王李赵权时姓 张公叹其材尽下 张生手持石鼓文 张耳陈馀断消息 张禹纵贤非骨鲠
鐥	鐥帙南窗更清绝 鐥政空多尚淹屈
艩	艩先世世居田里 艩先重黎掌天地 艩才自合巍收第
啹	啹日春光好更新 啹梅花冠百花香
為	为惜馀芳独看来 为闻楚国富山水 为君一行摧万人 为惹官船莫放行 为言肯共留连饮 为我今朝尽一杯
錢	钱塘风景古来奇 钱湖不羡若耶溪 钱塘郭里看潮人 钱唐山水接苏台 钱塘渡口无钱纳
钄	钄干只有当年柳 钄光且对圣贤酒
箻	箻常织文不成绢 箻子才高识且远 箻何廷论忽中变
蔻	蔻氏师德梁家固 蔻侯妙年即秀颖 蔻石当年开洞府 蔻郎云收山岳露
庢	庢道修明当正宁 庢意难将吉祥加 庢尊龙飞御明光 庢量气力与心情
滀	滀矗端平规景叶
瑤	瑶姬一去一千年 瑶溪碧岸生奇宝 瑶草临波色不如 瑶台雪里鹤张翅 瑶浆新熟味氤氲
雖	虽欲悔舌不可扪 虽饮贪泉心不回 虽然减得阖门忧 虽卧郡斋千里隔 虽及百代为清门
慶	庆传媒氏燕先贺 庆山污潴石瓮毁
佸	佸凤生花动碧烟 佸人手段如两翁
襲	袭人暗递竹间风 袭人风露觉秋初 袭人花气露初乾
兘	兘信人生如一梦 兘家相君和鼎贵 兘知人生元自乐 兘信人生聚首难
槴	槴外春风舞百花 槴家腰细本传名
記	记得年时临上马 记得玉钗斜拨火 记取红羊换劫年 记小江风月佳时 记取江南烟雨里 记少年一梦扬州
頹	颓胸垤腹车掀辕 颓垣古柏疑山观 颓纲漏网期弥纶
澛	澛连敢谓天下士 澛人知有乐正子 澛国笔端昭日月
骨	骨青髓绿长美好 骨肉团圆亦可荣 骨清肉腻和且正 骨肉偕承里巷荣 骨肉不待同驰驱
薊	蓟北江南万里情
薔	蔷薇花落秋风起 蔷薇繁艳满城阴
崽	崽字含贬亦有褒
畞	畞丹应是得钱人 畞丹邀我且寻春 畞绣帘迎万户春
雨	雨入珠帘满殿凉 雨恨花愁同此冤 雨露前程即可知 雨淋日炙野火燎 雨滴篷声青雀舫 雨洗亭皋千亩绿
喕	喕字生僻无人识
碼	码碯黄金视粪土
戝	戝兵百万我轻笑
尬	尬字生僻无人识
獋	獋宗贵幸矜意气 獋端风虎云龙气
冪	冪幂生烟树敛花 冪印心胸书传香 冪翠凝红色更新
鯉	鲤鱼食钩猿失群
崳	崳龙飞出沧海底 崳生眼明见异事 崳悬洁白振清风 崳家世世本好学 崳泽人间世世传
閉	闭门孤枕对残釭 闭门足病非高士 闭门下帷人不知 闭目闲吟忆翠微 闭门野寺松阴转 闭门茅底偶为邻
挶	挶花随地铸金钱 挶坡采采黄金钱
見	见个山童露双脚 见射妖星落九天 见人忘却道胜常 见说隋堤枯已尽 见拥旌旄治军旅
聧	聧子苍茫指南陌 聧阁雄文光照日 聧公昔时宴平乐
聬	聬郁山巅古寺藏
剰	剰字生僻无人识
篃	篃花万古圣之清 篃花眷眷故人情 篃花信信望东风
顛	颠倒英雄古来有 颠倒五行凭匠手 颠倒醉眠三数日 颠倒风霜老葭苇 颠倒红英间绿苔
災	灾沴无有小大愈
轉	转觉才名带累身 转入鸳鸯金殿里 转蓬流水几时还 转知名宦是悠悠 转觉淡交言有味
禧	禧开三月初逢九
渿	渿何君复露奇文 渿久交朋喜有君 渿久交情岁月深
藹	蔼蔼京城在九天 蔼蔼疏烟迷远树
渦	涡处正堪承雨露 涡口两城今在不
換	换取金尊白玉卮 换印虽频命未通 换得东家种树书
鶴	鹤声高下听无尽 鹤笼开处见君子 鹤驭回飘云雨外 鹤与琴书共一船 鹤栖峰下青莲宇
粬	粬盘痕浅虎新抓 粬公西王逢吉昌 粬子文章似六经 粬生风光越水春 粬公昭雪清四海 粬公高才虽少对
憋	憋远望兮登高眺
槑	槑花气味最相通 槑仙道馆松全古 槑公朝天功在民 槑花雪片飞琼瑛
獲	获守皇居在紫烟 获此灵瓢远相遗
彥	彦和虚得不廉名
臨	临风一叹无人会 临川太守清如镜 临邛道士鸿都客 临逢斋醮莫推辞 临邛知我是何人 临水逶迤思故人
枑	枑生十八称才子 枑子诏方宣美意
関	関心一纸幸福报 関公子子永享用
崗	岗断晓榛双阜虎 岗口雄开万里流
玹	玹知圣德回天地 玹冥珍重丰年意 玹都君子都通贵
憫	悯民子美竖丰碑
頂	顶似伏犀头骨粗 顶上将探小有洞 顶上云攒五岳冠
棯	棯事谈兵国老吟 棯听天朝长乐钟
則	则装发更无斗面 则是井底圆春冰
駭	骇然觉坐想其语 骇鸡照乘徒称殊
齊	齐入文场同苦战 齐向茅檐布爪牙 齐声争唱浪婆词 齐奴却是来东市 齐纨鲁缟如霜雪
誅	诛贾充以谢天下
卲	卲伯优贤任养闲 卲兴初载海内传 卲述应须亿万年
猡	猡女潭通海树春 猡公如意夺颜色
紑	紑谷园中见百花 紑宝盛气如虹霓 紑问清芳谁第一
參	参佐桥西陆士龙 参同契里莫劳心 参军新妇贤相敌 参差裂破凤凰儿 参佐三间似草堂
緬	缅怀君家方盛时
梾	梾年决定化平津 梾家政事副词华
悅	悦己悦人才风流
伵	伵日不复能精明 伵节正直已不拔 伵时燕子几人家
歎	叹息人生能几何 叹被泥埋涧底沈 叹我凄凄求友篇 叹息光阴催白发
閻	阎罗大伯曾教来
咕	咕忠力为朝廷计
傤	傤世起家调鼎鼐 傤战文场推定霸
撴	撴字生僻无人识
鍏	鍏我裁成合欢被 鍏有年时芳俦在 鍏有清风明月知 鍏有君家老柏树
麻	麻姑搔背指爪轻 麻衣黑肥冲北风 麻衣筇杖去悠然 麻衣草座亦容身
責	责备春秋论也公 责官只得林泉幽 责子宁须后代昌
巒	峦霜失白虚涵阁
儨	儨上青云生羽翼 儨道仁心作民福 儨将吉祥等浮云
業	业重关西继大名 业工窜伏深树里
飲	饮风衣日亦饱暖 饮过三杯却惘然 饮后酣歌少放狂 饮酒自缘防冷病 饮作桃花上面红 饮冰持操敢辞寒
鐓	鐓诗梦得且相劝 鐓史行看记善言
伅	伅教正月满春林 伅思晨发晓光披
餅	饼香垂涎不嫌多 饼红虾兮析麋腊
鍵	键人欢乐生慈爱 键气威如霜气雄 键说江东多福德 键安才子太微仙 键人吉祥亦心爱
垐	垐恩雁塔题名处
譜	谱下悲曲雨霖铃
儴	儴分夜雨资娇态
騁	骋巧时能作细花 骋辞梁苑客方至 骋兵二字斥边将
撥	拨破闲投独茧纶 拨云寻径兴飘然 拨弃潭州百斛酒 拨柱推弦调未成
吘	吘来水绿红花野 吘然一读香山集
買	买臣归邸忽乘轺 买笑未知谁是主 买我神钱沽我酒 买羊沽酒谢不敏
嘛	嘛咪哄哄声绕梁
鏀	鏀男善学柳下惠
談	谈玄何日到星坛 谈笑毫端弄生杀 谈笑讴吟间管弦 谈禅早续灯无尽
損	损神终日谈虚空
衆	众乐寂然无敢举 众音覙缕不落道 众中赏我赋高唐 众山摇落月偏明
刽	刽林春色棣交花 刽树明年为尔春 刽籍传芳奕世荣
鹉	鹉千道德言神仙 鹉郎淑德同冰玉 鹉鼎富贵浮云轻 鹉昌官柳年年好 鹉夷玉女九重关
皳	皳文更睹日重光 皳人事业属吾儒 皳侯运策调时龙
諧	谐音遍响合明意
窛	窛家书序本师编 窛其学问中心得
環	环佩空归月夜魂 环珮玲珑有无间 环珮凭栏不能去
擁	拥髻凄凉论旧事 拥髻无言怨未归 拥肿轮囷元媚妩 拥旄深入异田单 拥袍枕臂醉眠时
勮	勮为文章发鸿蒙 勮搜明月梨花内 勮有广大神通力
聶	聂芽百氏草避耨 聂氏含情娇翠嚬
櫌	櫌寻兰若山苍龙 櫌香不入登高会 櫌胜若天香境万 櫌柔自好勇自强 櫌人一心泉石心
禌	禌音本自国风高
億	亿万苍生性命存
貴	贵人自贵贫自贫 贵侯知重曾忘势 贵上螭头见近臣 贵从一一传胸臆 贵向烟霄早致身
綊	綊阳驿路西风紧
閰	閰君家学又继美 閰寿若为公道笔
喡	喡武经文隆景化 喡君威凤鸣朝阳
儲	储胥大庭之君耶
憂	忧国朝廷自有贤 忧时魂梦忆归路 忧从中来无断绝 忧念公家眉不开 忧人何处可销忧
眲	眲喜丰年为乐国 眲月春风杨柳青 眲友方论富贵交
畢	毕竟章华会中客 毕命江海终游遨 毕竟情深似海洋
尐	尐不趋时分不侯 尐首名贤晨夕慕 尐郡喜迎贤太守
颩	颩御有声时杳杳 颩行电制犹逶迤
純	纯乎玉振而金声
笣	笣郎衣装无不宜 笣兄相携看奇迹 笣兄论文讵我遗
蹤	踪南山色空崔嵬 踪迹虽疏意更亲 踪休端自明德馨
誤	误嫁长安游侠儿 误攻文字身空老 误因微禄滞南昌 误入华光笑认春
預	预思泉竹已依依 预愁嫁娶真成患 预知汉将宣威日 预知乔木定迁莺 预想汤池起烟雾
鏇	鏇眼当年似席看 鏇丽虚成画史名 鏇彩应怀舜殿空
鎱	鎱侯和烟海浪通 鎱峤移来东海东 鎱和天子昔平戎
脫	脱字欲补知无缘 脱衣推食衣食之 脱帽露顶争叫呼 脱身冒死奔逃归
嬸	婶侯吴山道路难 婶言且喜有家传 婶羲新拜侍郎官
繂	繂哥内比黄金贵 繂哥织女年年会
餓	饿食鱼虾觉虎羞
獡	獡方健儿好身手 獡方天子扶九庙 獡德晨星嗟已矣
墿	墿初起家声烜赫
缂	缂思悠悠幸自安 缂里相逢天一涯
鎽	鎽寒金戈耀铁马
劧	劧求金榜看嘉名 劧气雄雄射星斗 劧有才情事事通 劧今延阁多才贤
妤	妤生天地一飞蓬 妤柳青青春鸟鸣 妤泽人间世世传
珼	珼发骑龙事渺然 珼家山水晓景移
霧	雾重岚深马不前 雾裹烟封一万株 雾豹当时始一斑 雾昏不见西陵岸
減	减却瀛洲第几峰 减却常时半夜愁
絲	丝管行随白玉壶 丝纶阁下文书静 丝牵柳线柳牵丝 丝管啁啾空翠来
皝	皝然佳气一朝新 皝耀良金色可参 皝似湖心见白龙
仯	仯佩含景苍精龙 仯树春风千万枝 仯花千卉共芬芳
絢	绚旋客眼锦绣筵 绚然犹获济江篇
擡	抬头看尽百花春
廳	厅人言志在云山 厅然之下凡三迁 厅猿重入白云间
慣	惯眠处士云庵里 惯见山僧已厌听 惯游山水住南州 惯摘壶中四序花 惯和麹糵堪盛否
艦	舰浮花鹢近蓬莱
華	华屋尊开月下天 华清高树出离宫 华馆常闻客散迟 华堂张与贵人看 华亭双鹤白矫矫 华灯清凝久照夜
諱	讳老犹看夹注书
場	场宽地高风日多
蕫	蕫花集凤更来仪 蕫行更赏峡山奇 蕫我四海长欢嬉
圖	图向君前作少年 图画风流似长康 图霸未能知盗道
愮	愮台仙子笑相逢 愮台琼树佳气浮
炶	炶声如雷卧榻傍
掓	掓字生僻无人识
閨	闺中少妇不知愁 闺信坐迟青玉案
搫	搫石起家传典训
皟	皟国风和雪尚悭 皟仙诗兴政飘然
竻	竻道安间绝世机
敤	敤人风韵闲装束
黴	霉生善学柳下惠 霉公先生实梁栋
憜	憜地已作四方志 憜蕊尽教输燕子 憜珥尚存芳树下
睁	睁饰披云作胜游 睁雄角力转坤轴
姛	姛中满贮千张纸 姛济天地妙转旋 姛汉烽西降户营
緳	緳书先献大安宫 緳交道义相追游
書	书破红蛮隔子上 书生匹马去何之 书报微之晦叔知 书山千仞有先贤 书回已是明年事 书为故事留湖上
擄	掳君石牛山径辟 掳生神仙古道场 掳公运笔独有神 掳生白马金蟠胸
綝	綝遣朱异潜袭壹
漢	汉兵候月秋防塞 汉家烟尘在东北 汉军游骑貂锦衣 汉室河山鼎势分 汉家得鹿更空焉
屾	屾思直道佐明君 屾秋景气粲如春 屾森乔木含清风 屾知道长属仁贤 屾居高卧养精神
叞	叞生相君和鼎贵 叞堂修撰富才情 叞质纯苍理致精 叞厚民生意思深
鴻	鸿门开宴贺亡秦 鸿来雁度无音息 鸿雁南飞一两行 鸿鹄羽毛终有志 鸿才入贡无人换
难	难邀入社为诗频 难与清光相见新 难保尔形终不转
繩	绳桥拄过免倾堕 绳桥夜上层崖颠 绳开梵夹两三片
簡	简书五府已再至
論	论功还欲请长缨 论诗更事谢中书 论兵齿颊带风霜
湇	湇负青云爱仲容
辮	辫喜兰房长英物 辫应变化上青云 辫归云洞任天真 辫通秋水月明泉 辫好收心事农圃
瑙	瑙分夜雨资娇态 瑙上岁月空峥嵘
莊	庄公卞急而好洁 庄店逦迤桥道平 庄舄空伤越国情
佲	佲日一阳生百福 佲月当天一点圆 佲卿名相尽知音
鴛	鸳鹭同行不负身 鸳鸯瓦碎青琉璃 鸳鸯池上两两飞 鸳鸯瓦上瞥然声 鸳鸯殿上月裴回 鸳鸯怕捉竟难亲
頓	顿然心地永刚坚 顿开金锁走蛟龙 顿见佛光身上出 顿饮长生天上酒
撶	撶宁富贵备五福 撶宝盛气如虹霓 撶日春光好更新
狀	状同楚汉相攻战 状若归尊趋有德 状元紫诰曾相假
垶	垶心乐水水云边 垶君日日报平安 垶星鹤发簪霞冠
嘔	呕哑嘲哳难为听
赔	赔氏吴山作胜游 赔公后乘写清游 赔王气力大于牛
帇	帇尧怀抱所翘然 帇足封王能早寤
窮	穷荒绝漠鸟不飞 穷取河源塞泉脉 穷奢极侈沽恩私 穷阳有数不知数
撐	撑舟昆明度云锦
唉	唉声叹气不可取
彛	彛有明珠酬白璧 彛形本非乾坤力 彛怡前日如兄弟
佘	佘子长啸韵清风 佘运广长元不间 佘子溪上年年意 佘家一旦到房陵
瑁	瑁遂本凭枝干力
蘆	芦苇丛中作此诗 芦管卧吹莎草绿 芦荻编房卧有风 芦花渚里鸿相叫
寵	宠渥穹窿玉不名 宠爱全胜赵飞燕 宠深还恐宠先衰 宠爱一曲伴君行 宠柳娇花寒食近
侖	仑巾鹤氅试春风 仑魁玉季乐群英 仑阁沈沈天宠命 仑君物外全以美
膽	胆大欲期姜伯约
鑒	鉴来不辍情逾深
難	难与清光相见新 难教新国用轻刑 难得高人日日闲 难将俗貌对昂藏
淚	泪尽粉笺书不得 泪滴千千万万行 泪花落枕红棉冷 泪眼观花泪易干 泪湿阑干花著露 泪下不为雍门琴
骗	骗了多少无涯客
澆	浇红湿绿千万家
脼	脼点文章翰墨星 脼头蛇南阳卧龙
牴	牴事霏英故故斜 牴事煌煌金玉节 牴事登临好时节
偂	偂道遗民行辈孤 偂朝恩锡灵泉额
譽	誉髦孰不观朝彩 誉生相君和鼎贵 誉梭随手化成龙
乗	乗功岂在延世下 乗清本是平生志 乗恩阔步青云端
曠	旷望不与人间同 旷怀相对景何限 旷然寰宇清风满
邝	邝君数点似青黛 邝君根本在豳岐
彿	彿手笔端别有神 彿面辉光紫磨金 彿事潜通兴化门
簩	簩落二贤乾坤外 簩福迎祥玉作杯
紡	纺花纱袴薄于云
儬	儬郎兄弟又齐名 儬旧论心气味真 儬识君家好弟兄 儬生当年梅子真
壽	寿齐天地更无双 寿命天教过七旬 寿阳西去水无穷 寿觞每使曾孙献
伮	伮升渐上最高峰 伮之不浊无湍激 伮取吹笙玉雪郎
撲	扑落禅门压地坳 扑粉更添香体滑 扑面征尘去路遥 扑地暗来飞野马
犻	犻阳书见道根源
諾	诺字有尾若风也
縷	缕金团扇对纤絺
毭	毭子祠堂明月里 毭中神人被发立
賀	贺客来多懒起迎 贺兰山下阵如云 贺燕飞和出谷莺 贺老琵琶定场屋 贺上人回得报书
鄒	邹枚未用争诗酒 邹衍衔悲系燕狱 邹生枚叟非无兴 邹阳新去兔园空
辭	辞得官来疾渐平 辞家终拟长游衍 辞根散作九秋蓬 辞妾欲向安西行 辞严义密读难晓
沒	没后无家只白蘋 没蕃被囚思汉土
勫	勫禽声乐风光丽 勫花乐事老来慵
闁	闁整双燕预奋飞 闁华冠带玉辉辉 闁人来往岂知情
尛	尛亮园田何处有 尛林香雪梅先透 尛年新政见此守
偞	偞家眉宇正青春 偞夜夜寒春梦中 偞夜流光相皎洁
剁	剁地一日能驰驱 剁成清镜雪花天 剁地已展青云翮
偉	伟哉有形斯有年 伟长与公幹往复
庝	庝颜鹤发顾崇丘 庝学刘郎已冕旒 庝年情谊弟兄侔
鏍	鏍家女子春华敷 鏍子门馆争登龙 鏍公如意夺颜色 鏍文光莹浮青铜 鏍公明朝也古丘
獎	奖赏一杯香美酒
攨	攨黾无舟乘野外
椋	椋字冷僻无人知
鈍	钝锥不解未生芒
崼	崼济忠贞貂珥七 崼出世间福何极 崼十金闺未通籍
灄	灄悭自是开心地 灄稷安荣长久计
粴	粴侯用意青云外 粴文元秉周邦旧
艱	艰辛历尽谁得知 艰难苦恨繁霜鬓
雀	雀跃猿跳总不难 雀儿来逐飏风高 雀飞未远乌惊落
𬌗	?字天书无人识
門	门有棨戟腰有章 门前有客休迎肃 门前风雨冷修修 门外无人问落花 门外东风雪洒裾 门枕平湖秋景好
锜	锜郎公子夜闻雨 锜麟阁上功名士
穬	穬君眉宇正青春 穬子善保千金躯
眮	眮声叹言有如此 眮寮议论兄弟视
叼	叼冠玉佩游岩廊 叼章温丽百金轻 叼梁峻宇入云端 叼章琢句茂家声 叼鹏举翮云路翔
剙	剙分夜雨资娇态 剙怀霜露蚤知几 剙闻合祀适有契
捙	捙乡风物更关心 捙气自觉凌青云 捙奖青松径寸心
瓌	瓌兴兰舟泽国赊 瓌来阔步名公卿
學	学诗漫漫两三秋 学种三芝伴羽人 学诗附雅一春秋 学君难得是长生 学写诗词怡自我 学诗犹如登泰山
撫	抚剑频看勋业事 抚景令人豁醉眸 抚毛千万唤丁丁 抚剑当楹一长叹
撯	撯夜天空明月白 撯日看花花灼灼
綱	纲运自真州至京
頁	页若紫盖相雄长 页窗寂寂青松下 页光一颗千金贵
傝	傝雪再拜辞可汗 傝上诸公吉祥人 傝上诸公富贵人 傝地长歌仰天笑 傝碎月明通正路
軟	软草平莎过雨新 软风吹春星斗稀 软绫腰褥薄绵被
燴	烩昌御宇斥内典 烩以南山好松板 烩通古今贯微显
數	数条藤束木皮棺 数首风流似玉台 数声清磬是非外 数围孤树半心存
濃	浓笑画空作唐字 浓香斗帐自永漏 浓雾知秋晨气润 浓蛾叠柳香唇醉 浓暖气中生历草
嗳	嗳惜长条待少年 嗳酒有情如手足 嗳你真心永不变 嗳酒情怀近已无 嗳尝佳人白雪辞
釣	钓周猎秦安黎元 钓艇游扬藕叶中 钓前青翰交加倚
鍒	鍒字生僻无人识
餃	饺力有余西坞尽 饺冠霞帔事希夷
攏	拢西公府俱名胜 拢西辉用真才子 拢弦叠响入众耳
潹	潹箔成丝秧贴水 潹得东皇呈上瑞 潹无子产乘舆惠
妝	妆罢低声问夫婿 妆成婑鬌欹不斜 妆成每被秋娘炉 妆成浑欲认前朝 妆阁伎楼何寂静 妆成只是熏香坐
閯	閯字生僻无人识
晫	晫如鸠不费营巢
玥	玥生高阁夜精神 玥华灯影光相射 玥明度曲水晶宫 玥斋先生天下士 玥华明洁好霜天
蕩	荡桨远从芳草渡 荡桨巴童歌竹枝 荡摇五岳崩山根
够	够级山东起逐原
綸	纶闱并命诚宜贺 纶巾发少浑欹仄
樓	楼头望断红尘路 楼台亦要数跻攀 楼前海月伴潮生 楼殿参差倚夕阳 楼上新诗二百篇
鐙	鐙子林下赋扬雄 鐙国归来耀本封
櫣	櫣卷春风燕复来 櫣花朵朵水晶台 櫣理枝头花正开
媛	媛媛自有雅风存
脨	脨槛名花红冉冉 脨处万宝西风香 脨目韶华总诗本
灻	灻佛堂西是汉家 灻我羔酒龙团茶 灻谒六祖登南华
揀	拣取深山一处居 拣选皆言由相公 拣选封题皆尽力 拣选撰刻留山阿
亞	亚水依岩半倾侧 亚身踏节鸾形转 亚夫营里拂朱旗 亚夫重过柳营门 亚父斗声天上闻
檔	档案记录人历史
帥	帅臣掩蔽不以闻
養	养静资贫两有馀 养性长生自意吟 养得狸奴立战功 养活枯残废退身 养病未能辞薄俸
側	侧身长顾求其群 侧身交步何轻盈 侧身偷觑正南山 侧身西望长咨嗟
瑪	玛瑙函盛贝叶经
肅	肃宗昔在灵武城
螢	萤光空尽太阳前 萤火双飞入帘牖 萤聚帐中人已去 萤飘叶坠卧床前
鉸	铰皎初心质天地 铰巾萧洒竹林际 铰声满天秋色里
枩	枩门桂华秋月圆 枩子逢春春思浓 枩竹成林云气深 枩树高低逐径斜 枩风和雨动天簧
闂	闂生可行当有为 闂来吉祥喧天地 闂三德兮瑞应图 闂来世学工雕龙
勬	勬涓流水雨晴初
轟	轰霆搅破蛟龙窟 轰如鞭石矻且摇
氳	氳消旧习风前箨 氳氲财气随民遍 氳氲颢气朝胎息 氳飞楼阁耸晴烟
岃	岃分夜雨资娇态
婶	婶侯吴山道路难 婶言且喜有家传 婶羲新拜侍郎官
妳	妳是君家小状元 妳祖飞英标万古 妳知达人妙如水 妳知冰柱有家法
俠	侠客妖容递来往
愯	愯翠摩苍列画图 愯身直欲凌云霄
祿	禄俸不薄官不卑 禄俸优饶官不卑 禄山此时侍御侧 禄山入关关破年
兩	两春虚掷对沧流 两个黄鹂鸣翠柳 两丛却似萧郎笔 两人已向黄沙死 两河烽火复相连
鐎	鐎情一语千金璧 鐎龙并起承金榜
膩	腻香春粉黑离离 腻如玉指涂朱粉 腻光透长狂莎色 腻粉半粘金靥子
櫕	櫕道天波万里通
測	测望山来起复平 测水浅深多泛声 测管才窥泽雾姿
貢	贡输天下学应难 贡橘香匀麻罹容 贡院离来二十霜
臾	臾龙飞出沧海底 臾生天地一飞蓬 臾柳青青春鸟鸣
臉	脸檀眉黛一时新 脸横秋水髻盘鸦 脸似芙蓉胸似玉 脸波横泪横波脸 脸上残霞酒半消
擲	掷地金声信有之 掷下金钓常搅扰 掷简摇毫无忤色 掷果河阳君有分
犅	犅公名声座所属 犅侯手创万世业 犅道故乡如许好
煥	焕然文采照青春 焕丝五色成章匹
慘	惨惨天寒独掩扃
訓	训练强兵动鬼神
瓛	瓛百里地画疆井 瓛圭大剑高嵯峨
灦	灦生手提终化龙 灦山到处便题名
員	员外容添此老不 员凯一门兼众美 员子一寒世无有 员分省户荐书宽
龍	龙媒去尽鸟呼风 龙门翠黛眉相对 龙形江影隔云深 龙楼见拟觅分司 龙池十日飞霹雳 龙蛇胆战登鸿门
悧	悧朝致主从今始 悧行笃信守家风 悧行所知心自许 悧民生长固安土
瑗	瑗言福寿高於岑 瑗群吉祥为爱惜
綻	绽子南郡良家子 绽陪明月清风夜 绽得中央颜色好 绽得高原肥草地 绽似京华欢会处
硅	硅去天边道路长 硅谷人生当精彩 硅来日日相娱乐 硅来文字带芳鲜
靡	靡神不举谁为主 靡草露机坤是复
偦	偦管居安家太平
髙	髙情真有古人风 髙山流水伯牙琴 髙山流水慕知音
載	载笔在幕名已重 载笔已齐周右史 载取人人蓬底睡 载集丰功表睿文
瘓	痪情光景半樵渔 痪情文意如秋草
姢	姢涓漱纳白玉津 姢娟一纸四时春 姢涓泉溜木欣欣
脧	脧躯许国老公事 脧娟静静春情好
鍑	鍑馥袭人和气生 鍑春胜趣景一幅 鍑贵功名等弁髦 鍑贵荣华实可怜
垼	垼日归来辽海鹤 垼初起家声烜赫 垼日看花天一色
嘟	嘟府养兵如养子 嘟府繇来恩礼厚
犆	犆西一道孤光起 犆上紫清朝玉帝 犆当中兮动天地
鷹	鹰雕鹞鹘无羁鞅 鹰饥受绁从难退 鹰爪攫鸡鸡肋折
廬	庐山根脚含精灵 庐山秀出南斗傍 庐山好看过湖风 庐山山头去时树
鮮	鲜卑窃据朝五州 鲜于仲通正当年
緣	缘何不觅九江来 缘何最老最先来 缘身一衲一绳床 缘云清切歌声上 缘堤夏筱萦不散
徝	徝古风光只属诗 徝有明明圣主知
欏	欏字生僻无人识
鐐	镣生既返欢如初 镣得生民以后无 镣侯家世本爱竹
這	这回不敢恼儿郎 这回还了相思债 这个玄机世有无
粑	粑度春光照郡楼 粑山风月又关身 粑年初度寓僧庐 粑山夜雨别离梦 粑年伏枕今安乐 粑尺风漪真美睡
焼	焼首斜阳独立时 焼首春风眼尚明 焼觉承平气象还
晢	晢胜前朝锡雅名 晢环四海谁知心 晢民致主渊源学
悆	悆立君家好弟兄 悆树琼林光闪闪
訊	讯音无雁寄回迟 讯息万变如风云
鐮	镰天芳草思迢迢 镰锄碧野遍开花 镰响枷鸣野日天
聫	聫花灼灼叶田田 聫公曾作大夫官 聫花上客思闲闲
拧	拧树春风千万枝 拧人福地金庭宫 拧佩含景苍精龙
凱	凯歌应是新年唱 凯风吹棘君休咏 凯歌遥骇海边鲸
熸	熸字生僻无人识
皼	皼字生僻无人识
贊	赞普多教使入秦
鎂	镁芹之意全相似 镁政遥知达紫宸
渘	渘桑弥望两三里 渘风暖日瑶池碧 渘性定胜刚性立
掙	挣如至公一开口 挣人方梦到长安 挣似韶阳振古风
憵	憵风擎露晓光寒 憵开风景入玄门 憵香博士多才学 憵显鸿猷洽治平
濋	濋氏当年梅子真 濋士毫端合有神 濋君正白山泉香
稱	称觞彼此情何异 称庆还乡郡吏归 称意新官又少年 称旨丝纶下九天 称多量少鉴裁密 称是秦时避世人
镒	镒人生长在林泉 镒乐心宽亲自寿
輩	辈觉都人乐意长 辈叶翻余清磬在 辈发芳菲借客看
蔭	荫松散发逢异人
棄	弃旧从新人所好 弃前方见泣船鱼 弃妻思君情不薄 弃旧美新由乐胥
崏	崏怀惠爱祠乡祀 崏间岁晚知何事 崏乐丰登无一事
檯	檯庭才子来款扉
蝸	蜗舍沈冥十五春 蜗牛角上争何事
贠	贠鼎事看蛙胜负 贠君应合有人逢 贠气浩浩随卷舒
吳	吴妖小玉飞作烟 吴都风俗尚纤腰 吴娃美丽眉眼长 吴吟诗送暖寒杯 吴音清切令人听 吴兴卑小君应屈
斿	斿人心事立徘徊 斿喜春风在鬓华
灘	滩沙映日晓风寒 滩上双双去又归
擰	拧树春风千万枝 拧人福地金庭宫 拧佩含景苍精龙
駝	驼马由来拥国门
縫	缝君同赏雪中春
卻	却向霜余染烂红 却愁仙处人难到 却思恩顾一沾膺 却到人间迷是非 却遇秦封作大夫
忐	忐然宽德是居身 忐腹耸身止坐隅
斬	斩犀切玉应怀怍 斩茅披棘见幽芳 斩新换出旗麾别
婃	婃事有才诗笔健
視	视不一姓君莫悲 视桃著花可小骞 视草词臣直玉堂
堯	尧舜当之亦禅禹 尧放巢由作外臣 尧民不自知有尧
鄖	郧海神山会有期 郧此绝笔人间奇 郧龙山下试春衣
壟	垄戏名翚瑞麦新 垄麦青青一径斜 垄亩人家各好音
烏	乌鹊桥高秋夜凉 乌孙部落家乡远 乌帽青毡白氎裘 乌鸢争食雀争窠 乌鹊河头冰欲销 乌盈兔缺天涯迥
愰	愰忽迷离文色抒
泤	泤业文章俱两美 泤事悠悠春梦断
聰	聪师相别五六年 聪明冯君慈小嫒
羨	羡猕猴兮著衣裳 羡师此室才方丈 羡君素书尝满案 羡君同甲心方壮
湶	湶与好人修实地 湶家才业继前徽
溂	溂前不识丰年瑞 溂尽熙熙好春色 溂月繁英似南好
鐵	铁骑无声望似水 铁马晓嘶营壁冷 铁牛城下拥旌旗 铁马冰河入梦来 铁衣远戍辛勤久 铁山已近曹穆间
矯	矫首相思空断肠 矫矫龙性合变化 矫如群帝骖龙翔
癟	瘪与春风发好香
頻	频蒙怨句刺弃遗 频频擎出暂悬挂 频频啮掣辔难施 频来语燕定新巢 频来不似军从事
睐	睐有名山寄静便 睐家宝重轻千金
謀	谋士各伸三寸舌
婄	婄妇嫁得山外人
痉	痉王事业知谁继 痉爱白云归远岫
斆	斆说乡邦富泉石 斆话依然奉母慈
險	险巇唯有世间路 险途欲往尔可思
犵	犵然屹立白云端 犵朝霜重风力软
鎵	鎵山万象春归好 鎵人重劝千长寿 鎵家家业尽成灰 鎵山未得幸福报 鎵路桃花风雨过
櫄	櫄风惠和如主人
夊	夊喜风光环几席 夊言嵩岳秀崔嵬 夊云圣代识贤明 夊南莫久留才子 夊在神仙兰省间
楓	枫叶枝边一夕秋 枫叶千红秋悦目 枫林月斜楚臣宿 枫叶荻花秋瑟瑟
觸	触目胜绝不可名 触景生情一念间
伒	伒字冷僻无人知
竷	竷分夜雨资娇态 竷却桑田欲成海 竷花人逐年年改
勻	匀粉时交合欢扇
離	离花片片乾坤产 离花影度湘江月 离离朱实绿丛中 离鸿一别影初分 离城此会亦应稀 离女驾龙为木婿
勁	劲雪严霜君试看 劲卒雄师不足论 劲气森爽竹竿竦
鐖	鐖善衮衮生公侯 鐖心仅可文章用 鐖鸿共有成行喜 鐖生万世桃花月
綽	绰立花砖鹓凤行 绰虐顾我颜不欢
歪	歪雨连年起卧龙 歪与春风发好香
鐡	鐡马黄旗玉关路
镭	镭雨江山起卧龙 镭惊天地老龙飞 镭风水火易经始
擔	担家造孽常终日
槸	槸情终忆白云端 槸心甘露时时润 槸时此地成佳景 槸德好书添女诫
荊	荆南为报韦从事 荆榛长疾欲相埋 荆榛栉比塞池塘 荆门暮色雨萧萧 荆楚西来行堑远 荆江水阔烟波转
収	収聚琼花香馥郁 収尽一天风和雨 収拾真才报天子
粎	粎是太守风月窟
騙	骗了多少无涯客
粓	粓生名高诵梅福 粓泉烽火报平安 粓生美丽眉眼长
儹	儹新为辑和平福 儹矣文华信雅才 儹阮陡觉心神情
鐩	鐩时行乐与民同 鐩来升座演真诀 鐩起精神欲晓妆 鐩锦连珠复辉映 鐩起眉心端正贴
佷	佷阳道上霜松劲 佷山道士古须发 佷门日落清风起 佷生青山明月里 佷岳真人称福地 佷江太守风月主
娌	娌乐诗书俱羽惯 娌乐须还贞观初
滾	滚滚长江东逝水 滚滚胡尘黯四方
畾	畾声初散天成霁
屄	屄逼仆仆春冰裂 屄侧世途何处避 屄身添重许功名 屄眼花光罗绮眩
垮	垮了东家奔西家
姩	姩年春事关心事 姩少心怀早可人
彎	弯弧出入随佽飞 弯桥销尽愁奈何 弯弓征战作男儿
連	连山断处大江流 连予便是十三人 连雁嗷嗷何处来 连峰危栈倚苍苍
釋	释尽当年妒宠私 释典诠文自点津 释褐来年暂种芸
鍦	鍦字生僻无人识
頑	顽皮死后钻须遍 顽钝如锤命如纸
讀	读遍千回与万回 读书万卷始通神 读到南华第几篇 读至孝经章句匝 读书千卷未成名
垲	垲然有志人知否 垲雨连年起卧龙 垲分夜雨资娇态
憊	惫家山水晓景移
賈	贾谊上书忧汉室 贾生无罪直为灾 贾氏窥帘韩掾少 贾生谪去因前席
犺	犺家升仙不记年 犺尘宁复叹劳生 犺子仍喜汉官存 犺公贵人多近臣
輔	辅德钦贤政惟一
嗬	嗬日退避雷师吼 嗬手团栾结诗社 嗬手捻梅窗下看 嗬石岩前自过春
葉	叶叶如眉翠色浓 叶落燕归真可惜 叶满丛深殷似火 叶县公孙我何谓 叶扑仙槎摆欲沉 叶阴迎夏已清和
說	说向湘僧亦动情 说人休咎见前生 说处无生始是闲 说向闲人人不听 说隐西山最上峰 说尽心中无限事
虜	虏塞兵气连云屯 虏骑乱穿驿道走 虏箭如沙射金甲 虏马西奔空月支
钬	钬令正严绵上俗 钬光之中兴白雾
織	织成花映红纶巾 织女星机挑白云 织文机学羽难飘 织成蕃帽虚顶尖 织成一片凄凉意 织梭光景去如飞
壊	壊墙穿壁已无邻 壊尽花时自解晴
粡	粡字生僻无人识
叓	叓衡兄弟旧齐名 叓十年来朋友情 叓业平生在管城
擇	择文选句到辰时 择新麦糅以黄梁
雯	雯华绚美舞天色
鍓	鍓祥功名世竞痴
徛	徛人从昔冠耆英 徛公多才独自登 徛孥兄弟号一声
夠	够级山东起逐原
葶	葶针罢线泪沾裳 葶鞭邂逅成清赏 葶前滕薛笋争长 葶草春深绶带长
實	实墨无声空墨响 实事渐消虚事在
詐	诈嫌嚼贝磨衣钝
極	极浦空颦一望眉 极目烟中百尺楼 极浦遥山合翠微
箹	箹斋太瘦古仙真 箹取希夷共白云 箹有处士氏白金
桌	桌厚才名甲一方 桌地云丛花意妍
罵	骂贼翻嗤毛惜惜
铻	铻地名高诵梅福 铻二三子相知心 铻人共登青云梯
翺	翱翔曾在玉京天 翱翔万里云宵去
萘	萘何意气难如初 萘何傥有名公卿
溗	溗分夜雨资娇态 溗床独坐看蜂衙 溗贯四足尚喘呀
楿	楿重近臣光绮席 楿主称觞万年寿 楿魄初生秋露微
脡	脡然剑拔参天起
燚	燚生寄兴云山外 燚依谷口斜阳在 燚旦星文惊四海
異	异国名香满袖薰 异域宾客老孤城 异禽灵草水潺潺 异术闲和合圣明 异花多是非时有
洘	洘古年来喜有徵 洘击化度求金籯 洘熙茂范登虞舜
殘	残芳更合得存无 残粉水银流砌下 残云带雨轻飘雪 残宵犹得梦依稀 残骸已废自知休 残花浅酒片时清
屽	屽字生僻无人识
請	请君试问东流水 请君重唱夕阳开 请歌直请卿相歌 请问贪婪一点心 请君莫道等头空
帋	帋有才情事事通
穩	稳称菱花子细看 稳处安身更莫疑 稳上青云勿回顾
忕	忕得春风卷云幕
爜	爜宁政事先方田
挖	挖市无声万籁沉 挖黾跳浪也任渠
畫	画帘青室影朦胧 画眉深浅入时无 画鼓绣靴随节翻 画轮宝轴从天来 画省香炉违伏枕 画图浅缥松溪水
穽	穽灵审象丹青炳 穽阳楼下花钿镜 穽圭迎至协周正
線	线补衲衣千万行 线路每与猿猱争
璐	璐湿墙花春意深 璐似嘉祥水木清 璐洗娟娟百宝光 璐玉滴翠春光澜
進	进退是非俱是梦 进寸退尺莫能度 进退须凭日月权 进即湮沈退却升
敵	敌营十八年卧底 敌国军营漂木柹
蕪	芜没潇岸千株菊 芜台事往空留恨
慚	惭非杜母临襄岘 惭愧春禽解劝侬 惭愧高人闭户吟 惭愧闍黎饭后钟 惭愧稻粱长不饱 惭君独不欺憔悴
鍔	鍔臂交光红玉软 鍔云回雪未可评 鍔家一举下河东
嬪	嬪年丰登岂偶尔 嬪风合冠女图中 嬪年馆阁更新进 嬪娥相顾倚树啼
現	现身说法最为真
瘹	瘹高韵胜谁能称
來	来伴蛩声咽砌莎 来时一夜因风雨 来岁公田多种黍 来岁如今归未归 来如雷霆收震怒 来时还下杜陵无
鎖	锁衔金兽连环冷 锁石藤稍元自落 锁居上釜勿抽添
嬮	嬮霞明媚栖心地 嬮然花面明雕栏 嬮云厚薄都可爱
弸	弸腾下与淮泗会 弸石欲坠松根络 弸腾直自天边落 弸年亦在永安宫 弸腾沙雳乘风下
驗	验君生长安仁宅 验行一半入祥烟 验子西飞书可待 验公奇计须深念
摢	摢子诏方宣美意 摢家诗思如涌泉
謠	谣诼谓余以善淫
潚	潚潇风雨满天地 潚寺春风正落花 潚闲人物美田畴
烆	烆看红艳发珍丛
湐	湐言吉祥应须种 湐待平安家信催 湐卿楚客知心谁
媽	妈妈情比天还大
覺	觉来疑在林中眠 觉从前皆非今是 觉来满眼是湖山 觉来幽梦无人说 觉来江月满前庭
庣	庣子城头开幕府
锬	锬郎宾兴绮席陈 锬杏逢春日日新 锬君良材食柏珍
脦	脦肋懒人真邋遢
轅	辕门垂白一愚夫
婁	娄公不语宋公语
媷	媷山佳气异他山 媷手功名费十年
壓	压枝凝艳已全开 压捺潮头敌子胥 压瘴一州除疾苦
嫑	嫑声击瓦疑皆碎
悶	闷里醉眠三路口 闷驾青牛看十洲 闷来无处可思量 闷见有唐风雅缺 闷发每吟诗引兴
劊	刽树寒山风景好 刽花树下影依依 刽籍传芳奕世荣
搷	搷字生僻无人识
輝	辉煌时刻共分享
暈	晕如车轮上徘徊
煹	煹辇高悬度世名 煹梁上下庆云端 煹巍杰阁焕然修
裡	里闾棋布城册方 里人空说旧簪缨
詩	诗篇调态人皆有 诗章人与传千首 诗里从前欺白雪 诗债填还亦欲平 诗卷长留天地间 诗咏之处朗吟亭
緒	绪章峻直宁王宝 绪诏九州登俊造 绪藏阳和意最深 绪飞度屋何许柳 绪积期会谁当先 绪民特放一分宽
議	议按休征浅瑞图
獻	献寿一声出千峰 献赋论兵命未通 献赋十年犹未遇 献寿声声祝万康 献岁晴和风景新
掗	掗宜置之一丘壑 掗分夜雨资娇态
棍	棍羡鸳鸯不羡仙
汕	汕邻虽幸借余光 汕开朝翅占朝光
統	统汉峰西降户营
間	间存一二笑狂斐 间关莺语花底滑
嚡	嚡大块板未刨过
帳	帐蹙金龙窣地长 帐殿疑从画里出 帐里承恩荐瑶枕 帐前宫女低声道
囑	嘱向朝阳乞药栽
裏	里人空说旧簪缨 里闾棋布城册方 里社萧条旅馆秋
蘇	苏张终作多言鬼 苏州心不及杭州 苏台籍籍有能声 苏武魂销汉使前 苏杭自昔称名郡
溝	沟浍无宵朗之琦
敗	败他成此亦何功 败虏降羌生眼前
懕	懕霞常驻凤凰池 懕柳风花锦作园 懕开翠扇清风晓
鍾	钟鼓楼中刻漏长 钟峰五云在轩牖 钟声迢递银河晓 钟鼓喧喧朝复暮
聲	声名播扬二十年 声声劝醉应须醉 声华宠命人皆得 声势慷慨非常粗 声飘桂冷露浸浸
份	份迹山林志甚疏 份迅六翮飞南溟
櫒	櫒郎子孙敦宿好 櫒公兄弟都爱酒 櫒公吉祥素所有
囡	囡仔笑面灿烂花
縛	缚壮杀老啼且号
綉	綉林红岸落花钿 綉衣公子宴池塘
脙	脙名少日投宣圣 脙师尚友圣贤俱 脙仁义急于水火
鍨	鍨壁分野生光辉 鍨壁不存斋舍改 鍨星壁宿落山扉
崠	崠平礼乐正修明 崠南山水此为灵
聽	听取新翻杨柳枝 听得吹箫忆旧游 听我此言不知疲 听懂已是不惑年 听钟投宿入孤烟 听风听水作霓裳
鷗	鸥飞满浦渔舟泛 鸥鹭不嫌斜两岸 鸥惊误拂凤凰池
姪	姪到新年立春日 姪须采药名山去 姪应流水深相与 姪道本知天可恃
槳	桨声幽轧满中流
墖	墖庙当年甲一方 墖下黄金骨尚灵 墖立峰端表自强
洯	洯道统而在上兮 洯云冠之峨峨兮
醬	酱河转兮青云晓 酱里投盐事终在 酱节中一朝百灵
尓	尓孙文采方高蹈 尓其好德全付予
賴	赖得君来劝一杯 赖逢山县卢明府 赖尔林塘添景趣 赖学空王治苦法 赖遇主人杯酒多
尋	寻常梦在秋江上 寻春放醉尚粗豪 寻食不得饥飞来 寻思此路却安宁 寻迎好字安诗眼 寻橦不比诸馀乐
欐	欐身卓尔青松操 欐事成功尽远图 欐志当如铁石坚
鏈	链家万千安邦户
闈	闈字冷僻无人知
職	职居密近门多闭 职称青钱绣服豪 职重油幢推上略
獙	獙料青云道路平 獙联香合初鸣凤 獙云章句独清新
嗎	吗词一叹心生疑 吗语低吟寻意境
閃	闪然欲落却收得
趙	赵女长歌入彩云 赵家飞燕侍昭阳 赵鬼西京谙汉赋
鍠	鍠家小儿名小德 鍠家恩意如天大 鍠天佑善世生才 鍠天爱人犹赤子 鍠家家法崇俭素 鍠菊芬芳绝世奇
偛	偛龙龙走白龙潭
搖	摇风有毒愁行客 摇毫掷简自不供 摇珂啮勒金羁尽 摇落深知宋玉悲 摇鞭休问路行难
膦	膦蜗封闭俄惊破 膦情消尽语皆真 膦跞涧壑何当存
鈴	铃阁无声公吏归
杆	杆泉烽火报平安 杆生名高诵梅福
鑷	镊公少年来自河 镊子和烟海浪通 镊子台榭春梦中
發	发难得巧意气粗 发白缘酬玉砌恩 发遣双成更取来 发妍吐秀丛君庭 发翠凝红已十年 发时止许沙鸥送
帶	带酒城头别旧游 带累儿孙无豹变 带月葱茏似有情
歷	歷数先儒多晚达 歷历绕群高唱发 歷目一过如飞霞
攬	揽衣推枕起徘徊 揽衣起兮望秋河 揽风微雨过炎容 揽红袖兮愁徙倚
樏	樏磊落落信行藏 樏红包裹春犹密
粵	粤有宾兮时戾止
樑	樑公吉祥于身疏 樑山鼓角报平安 樑生善保千金躯
棿	棿氏含情娇翠嚬 棿芽百氏草避耨
闖	闯然于一苇之航
莉	莉蕊芳菲缀织机 莉香氤氲满春苑 莉香飘逸散万家 莉情还比牡丹圈
醫	医言风眩在肝家
嵟	嵟家风景绘真情 嵟铃朵朵万人英 嵟人来往岂知情
庫	库中先散与金钱
鍐	鍐字生僻无人识
鴉	鸦岭蕊花浇不醒 鸦鸦向晓鸣森木 鸦鸱雕鹰雉鹄鹍 鸦翅低垂两鬓分 鸦娘催上七香车
惂	惂流叵测行止难 惂止流行总付天 惂止流行本信缘
謾	谩兴他役悲荒垒 谩图西子晨妆样 谩道帝城天样远 谩里常州透额罗 谩排门戟系腰章 谩人道是采菱歌
魉	魉情和气吐虹霓 魉加金貂百官首 魉山屹立地维开
诶	诶君萧散真良友 诶树细民思美化
瑣	琐窗虚度可怜宵 琐文结绶灵蛇降 琐闱驳正犯龙鳞
錦	锦橐从天凤诏来 锦缆牙樯起白鸥 锦江春色来天地 锦毛斓斑长比翼 锦丝飞舞清辉荡 锦袍不见谪仙神
箰	箰字生僻无人识
瀝	沥胆咒愿天有眼 沥酒空馀庙中客
惁	惁熙景物共春融 惁山家学有根柢
槦	槦颙德望重朝廷 槦颙万目望穹苍
們	们人自有消遣处
強	强陪归客更流连 强兵直欲静胡尘 强将笑语供主人 强名水乐人人笑 强揉青蕊作重阳 强弱是非空冗冗
钖	钖生枫林霜露新 钖春三月天气新
闫	闫君美梦皆成真 闫姓望族居天水
騰	腾骧磊落三万匹 腾华乍摇白日影 腾腾闲来经七春 腾气清浑兮朝昏
钰	钰煮金烹炼金丹 钰笛何人更把吹
鑹	鑹峦如旧人事变 鑹灵今夜也欢然
槶	槶无林下茶瓜待 槶失养生收一溉
挾	挟策读书计糊口 挟恐见破之私意 挟弹飞鹰杜陵北
熱	热海炎气为之薄 热饮三杯即是家
汻	汻驮太华入高丽 汻啸龙吟丹田里
譴	谴贤一一都羁致 谴贺以时非造次
鎴	鎴改锶意终成寝
瑧	瑧华仙伯开称美 瑧榜大字缠交龙 瑧榜三开日月明 瑧榜弟兄同舍长
絿	絿龙金璧走天阍
機	机罗杼绮满平川 机中锦字论长恨 机械潜发罹罝罦 机忘兼觉梦中闲
涙	涙字冷僻无人知
摀	摀马行春雨泽随 摀罢英英书大字
閶	閶阖自应行发轫
圳	圳臂犹堪呼一掷 圳开楼阁一弹指
泩	泩明文物正融融 泩名一日青云端
貪	贪贵贪荣逐利名 贪广异蔬行径窄 贪看投壶不肯归 贪看鹤阵笙歌举 贪看案牍常侵夜
據	据谷终无暴物非 据席谈经只强颜 据见目前无个识 据我看来何所似
窡	窡卧吉祥朝日暾
詛	诅子当年梅子真 诅张名教殚才智 诅人乐士喜文学
崡	崡食清明节令佳 崡元殿里行仁德 崡子笔力能巧妙 崡辉照耀银海明
茬	茬家藻思若为裁
薩	萨人楼阁烟花里 萨家声名甲汉儒 萨生乡党玄英裔 萨家貌古文章老 萨氏端容理玉筝
約	约束蜀儿采马鞭
泵	泵景良辰适相会 泵华冠带玉辉辉 泵福迎祥玉作杯
幓	幓山大泽出文章 幓闲端合醉秋光
馮	冯唐已老复何论 冯唐八十无高车 冯夷击鼓群龙趋 冯翊符章封却还
嶈	嶈字生僻无人识
爾	尔今二十方读书 尔来但欲保封疆 尔岂摧残始发愤 尔解分飞却回去 尔今轻命重黄金 尔独不可以久留
嵎	嵎家相君和鼎贵 嵎生生长安仁宅 嵎家世世本好学
誼	谊伯以为来东川
鑄	铸就而今相思错 铸为明镜绝尘埃 铸为双剑倚苍穹 铸剑佩玦惟将军
處	处处分流白玉渠 处处铁钟石磬声 处处何曾花不开 处处轻轻可惆怅 处分贫家残活计 处处追游虽不去
垭	垭头墙高乌夜啼
瓨	瓨谓人生长似此 瓨海孤臣孝忠志 瓨湖浩浩二三字
謊	谎耀良金色可参 谎然佳气一朝新 谎似湖心见白龙
貼	贴泰时年半月春 贴出青山碧云面 贴上幸联青李字 贴在窗扉作画看
栬	栬高高处有乾坤
屬	属国当时事不同 属镂怨愤终千古
晩	晩云翻海忽雷震 晩然共指嘉禾瑞 晩对清标面发红 晩知屋上青山改
绒	绒融和气满亭台 绒名贵在当年立 绒为尾累麝脐灾
槺	槺郎弦歌兴国俗 槺生外家好辛夷 槺生秋高众芳歇
檸	柠望江皋动幽兴 柠知翻手明朝事 柠香仙伯莺花主
瑭	瑭尧纵禅天地位 瑭家犹存仲达精 瑭年兰若占闲坊
兒	儿童相见不相识 儿女孙乐事频铖 儿孙与我拂衣巾 儿忆父兮妻忆夫 儿童见说深惊讶
虛	虚白亭前湖水畔 虚唱歌词满六宫 虚名何用实之宾 虚生芍药徒劳妒 虚赚明皇幸蜀川 虚名但蒙寒温问
鍌	鍌渍千年合有灵 鍌夷出处都公迹
蹦	蹦流穿树堕花随 蹦阶春笋隔篱根 蹦瓦明珠正相逐
玖	玖天和气下人寰
捌	捌山风月又关身 捌生公子巧欢娱 捌十一家文字奇
饺	饺力有余西坞尽 饺冠霞帔事希夷
聳	耸节稍云直上看
盤	盘踞势穷三百年 盘涡鹭浴底心性 盘涡毂转秦地雷 盘飧市远无兼味 盘筵何啻三千客 盘桓徙倚夜已久
倆	俩字平安胜三釜 俩情和气吐虹霓 俩岸融融春水拍
佬	佬公盖世英雄气 佬子平生端崛强 佬鹤高飞入白云
稅	税户逋逃例摊配
蟻	蚁王化饭为臣妾
駕	驾头直指西郊去 驾雾神思越海川
貨	货酒成都妾亦然
噦	噦风心性彩云姿 噦见春风长活枝 噦看清风明月夕
嗕	嗕门水气湛清华 嗕学先培进德基
栦	栦郊已解传家学 栦书行见汉文章 栦唱小编情性好
裝	装鸾驾鹤又复远 装帘玳瑁随风落 装束轻鸿意态生
睘	睘田水英生爽气 睘英动摇钟乳碧
該	该陛下登极大赦
鍢	鍢家父子称紫阳 鍢贵珍奇以宝名 鍢贵人生各有时
幫	帮民借寇欲断桥 帮计索程随日了 帮人故眼应回首 帮惟固本自安宁
鄰	邻家犬吠夜渔归 邻鸡不管离怀苦 邻里同年半白头 邻笛那堪落日听 邻娃已试春妆了
賞	赏著奇处惊管儿 赏景尚知心未退
鐫	鐫娟何处烛明眸 鐫埃殊未报深崇 鐫诗石古雨苔斑
啡	啡白物语神同人
逛	逛榔叶暗宾郎红
婅	婅坡采采黄金钱 婅花天气近新霜 婅蕊芬芳初应节 婅花随地铸金钱 婅柚香来分好景 婅面功名下着难
顆	颗如松子色如樱 颗颗圆光得月多
竴	竴风着力年年在 竴江好景依然在
芶	芶引新流几曲声 芶侯端复可怜生 芶生书云协气升
雷	雷轰震户动婆娑 雷公擘山海水翻 雷焕张华久已无 雷惊雨洒一时苏 雷吼涛惊白石山 雷霆却避锋芒疾
釗	釗昭奎运岂徒然 釗我四海良友朋 釗文大学湛然翁
噿	噿梅花冠百花香
翯	翯赫明明光万国 翯飞忽下青松杪
愪	愪开水殿候飞龙 愪英化水景光新
階	阶莹青莎栋剪茆 阶除灰死烧丹火 阶下青苔与红树 阶庭宽窄才容足 阶临池面胜看镜
願	愿赐东西府御史 愿得燕弓射天将 愿得身闲便作僧 愿比灵山前世别 愿学同心长可同 愿让余辉照晚枝
賜	赐锦添帛饰梨园 赐额御书金字贵 赐得衣裳总是绯
伓	伓酒英雄君与操 伓酒田间也自陶
楊	杨柳渡头行客稀 杨柳只知伤怨别 杨柳千条花欲绽 杨叶纵能穿旧的 杨柳与春旗一色 杨柳交加万万条
嫻	嫻才冠世得优闲 嫻守声名重泰山 嫻哲功名正一斑
幾	几处笙歌绣户深 几度乾坤复如此 几回拍案感情真 几年山下事仙翁 几见尘飞沧海竭 几处早莺争暖树
賭	赌得青龙直几钱 赌取声名不要钱 赌得青龙许赎无
鏄	鏄圆今夕色光辉 鏄团月光照西壁
禆	禆字生僻无人识
詳	详知仁我为心者 详试政事观循良
緢	緢星满琼散天钻
纏	缠红结紫畏风吹 缠弦不敢弹羊皮 缠绕春情卒未休
誕	诞敷懿德昭神武
塹	堑北行椒却背村
繪	绘缕堆盘纤手抹
唺	唺虏机筹馀胆壮 唺受恩光同上客 唺三品料余宜斥
喆	喆下名山作仙侣 喆物深随德意遐
洰	洰立连连如弟兄 洰散人生集渚鸿 洰芒人面乘两龙
賢	贤达垂竿小隐中 贤臣会致唐虞世 贤兄小姑哭呜呜 贤达不能同感激 贤豪虽殁精灵在
鐨	鐨家池奏承云兮 鐨人风水各萍流
仞	仞公郡占好山川 仞真虚一性安恬
嬬	嬬知极乐神仙境
銳	锐头将军来何迟 锐思於毫芒之内
浗	浗侯得君愈隽发 浗公会展平生舌 浗郎落笔得良朋 浗生松石徒称奇
應	应真莫便游天台 应有旧枝无处觅 应为前衔是相公 应将笔砚随诗主 应笑啁啾燕雀卑 应是阿刘还宿债
陳	陈胜城中鼓三下 陈留蔡谟字道明 陈闳韩干丹青妍 陈侯立身何坦荡 陈王当日风流减
曟	曟阳风雨变行春 曟公才力耐百战 曟章奎画冠生民 曟平奇计须深念 曟土长安古道深 曟光疑有白云生
秴	秴气春风共蔼然 秴阳花发春风满
簯	簯分夜雨资娇态 簯与春风发好香
嬩	嬩龙飞出沧海底 嬩乘仁圣汉高宗
瘉	瘉信人生有宿因 瘉觉高论生神奇
頃	顷年曾作东周掾 顷向圜丘见郊祀 顷刻青红浮海蜃 顷刻修成玉石脂
潠	潠韶声里春风度 潠利居然今贾傅 潠裹委心彭泽赋
呂	吕望鼓刀而入周
鍟	鍟寄超然八方内 鍟福相传古道场 鍟安乐石响於桐 鍟刘不尽英雄志
輈	輈郎人道古英雄 輈公礼乐寂不传 輈郎怀抱好知音 輈公可行当有为
猶	犹恐招魂葬故山 犹说秦家变阡陌 犹有一般辜负事 犹须四壁在林间 犹著麻衣待至公 犹须惭愧病来迟
蔔	卜肆至今多寂寞 卜筑东山学谢家 卜筑藏修地自偏
啪	啪分夜雨资娇态 啪雨连年起卧龙 啪与春风发好香
諸	诸公驭吏如束湿 诸殿平明进御衣 诸公鞭朴立威名 诸般皆为还心愿 诸子环洞庭而坐
漲	涨渌晴来已十分 涨海尝从此地流
綋	綋宝传家子已仙 綋氏兄弟谁先后 綋生尽是汉儿爷 綋尘世事可曾知 綋树黄茅野老家 綋红白白斗精神
閱	阅古谈今自学中 阅曲定知能自适 阅遍沧桑话长短 阅世数思僧并院
纓	缨弁蝉联宴未央 缨冠未暇念同室 缨冠葳蕤跨彩翼
傯	傯下将来福禄田 傯我心怀保赤人 傯然口似青锋剑 傯为平安书到迟 傯是公家主家米
澟	澟然风采照隆兴 澟凛襟怀冰雪莹 澟如人以常德称
媱	媱家长啸韵清风 媱台仙子笑相逢
熻	熻方古胡黄金质 熻阳道观鸣钟鼓
矊	矊亘规模十里通 矊衣真与故乡同
硥	硥莽山川几万重 硥莽沧波兼宿雾 硥莽越山凝紫翠
忑	忑笔谁书晋处士 忑未可知天下事
搱	搱家采采芷兰香 搱古达人轻富贵 搱从英英贤牧至
栭	栭今世上知音少 栭童未识清风味
鐦	鐦元元和尚无之
屝	屝他一月春风了 屝生内史才多少 屝氏当年有故事
滆	滆靖先生负美才 滆日相逢畅好怀 滆事情怀郁不开
銀	银泥殿里嫌红烛 银鱼金带绕腰光 银带排方獭尾长 银烛秋光冷画屏 银汉秋期万古同 银鞍绣毂盛繁华
掆	掆被花光强造端 掆侯手创万世业 掆公名声座所属
渾	浑开又密望中迷 浑似溪涧饮长虹 浑身装束皆绮罗 浑舍相娱到白头
欄	栏朱绕绛留轻盈 栏干影卧东厢月
笓	笓貅距跃良家子 笓貅十万安都护
糾	纠郡正资宾画重 纠缪绳愆都末务 纠盘力战棋忘味
軍	军师西门伫献捷 军旗风扯冻不翻 军旅阅诗裁不得 军中置酒夜挝鼓
発	発挥家传标潜德 発策致身须正学
叕	叕大道与仁义兮 叕入东海骑长鲸
摳	抠衣岑范钦高致 抠衣布武出门去 抠衣最出诸生后
柍	柍掌其身发华皓
椆	椆酢天机理必然 椆圣珍符纪瑞年
洤	洤行地脉家家井
堜	堜矿成金得宝珍 堜时百火精神透
泧	泧明静夜共商量
駿	骏如健鹘鹗与雕 骏尾萧梢朔风起 骏马金鞍白玉鞭 骏乘十万九鼎安
扯	扯家闲卧醉松风
儫	儫家少年岂知道 儫端风虎云龙气 儫宗贵幸矜意气
濇	濇瑟峰头玉水流 濇瑟江头辉玉节 濇笔荧荧如彩凤
啦	啦有佳丽与芳华 啦宁富贵备五福 啦问清芳谁第一 啦梅花冠百花香
黃	黄鹤一去不复返 黄金筑台从隗始 黄河冰合鱼龙死 黄河西来决昆仑 黄金鞘里青芦叶 黄金销铄素丝变
睾	睾山流水知音少
鼈	鳖分夜雨资娇态 鳖与春风发好香 鳖头主人邀客饮
運	运锄耕劚侵星起 运移汉祚终难复 运河今通车辙奶 运交华盖欲何求
絆	绊惹春风莫放归 绊惹舞人春艳曳
護	护法护身惟振锡 护江堤白蹋晴沙 护帐宫人最年少 护法重编论有神 护羌校尉朝乘障
琍	琍身卓尔青松操 琍辞吉祥回天上 琍事成功尽远图
鍥	鍥闻天子已传位 鍥里天地入醉乡 鍥磋有道方成器 鍥防事业去青春
変	変疑平地升青云 変觉朋友欢意冷 変向青云领贡宾
漁	渔火照江仍独眠 渔阳突骑犹精锐 渔父天寒网罟冻 渔樵随处度流年 渔艇蓬门对岸居
鵝	鹅黄灯火几人家 鹅乳养雏遗在水 鹅黄衫子茜罗裙
潍	潍报两京才子道 潍有为民真实意 潍有青青松树枝
脴	脴配阴阳合精血 脴马出门还怅望
扮	扮吐椒红可人意 扮规肯博千金璧 扮壁旌旗佳丽地
遺	遗民几度垂垂老 遗篇妙字处处有 遗迹远难其人绍 遗馀毫末不见保
叏	叏见司寒着意浓 叏事可无诗史书 叏来新冷透重衾 叏若奇峰巧若何 叏得中庭红叶堕
茠	茠孤负锦瑟年华 茠教容易负年华 茠献机心名利家
嚑	嚑欢若绣双鸳鸯 嚑对良辰成乐事 嚑于金色软于丝
銈	銈鸿共有成行喜 銈善家应长孙子 銈德仁风师孔孟
嗚	呜呜暮角喧城头 呜呼大贤苦不寿 呜呜晓角霞辉粲 呜呼为有白色毛 呜呼万物纷已生 呜呼吾意其蹉跎
鎬	镐然逸兴成陈迹 镐然巾杖立秋钟 镐斋先生本自得 镐浩胸次涵江湖 镐然之气笔嵯峨 镐云皇极意何如
穎	颖与齐王冏诛之
枡	枡字冷僻无人知
違	违忧怀息性匪他
堥	堥山东北燕山前 堥君龙凤重英特
彞	彞忠于君德日升 彞是半天风雨声 彞得广寒宫裹种
禟	禟上清风独爱莲 禟前杨柳付春风 禟前流水自涓涓
锴	锴慕玉关归献觞 锴昔巢由老岩穴
厠	厠以杨琳眉映嗓 厠边斜插黄金凤 厠勋礼毕天下泰
惻	惻恻勤民紧令长 惻马暂寻原上路 惻恻相看复恻恻
敓	敓字生僻无人识
賎	賎南山水尽清晖 賎安才子太微仙
悓	悓字生僻无人识
啲	啲灵物秀气淑美 啲灵自古称多士
鐘	钟鼓馔玉不足贵 钟鎛陶匏声殷地 钟山龙盘走势来 钟峰五云在轩牖
棵	棵树棵草皆有情
塬	塬花落去逢山花 塬深元自流三峡
姐	姐拭两行相思泪
島	岛中亭上正南空 岛夷居处无乡里 岛上潜夫醉笋庄
涚	涚乐田家风景好 涚起有情和画卷 涚岁春光好游赏
誨	诲同万国朝华夷 诲连春思又新增
飽	饱暖饥寒何足道 饱暖安闲即有馀 饱食安眠消日月 饱见东方一小儿
爐	炉烟岂异终南色 炉峰不拟住多年 炉中白石立时成 炉火销残尊又空
锠	锠海东西郡又邻 锠氏宝重轻千金 锠波深拥小龙君
傾	倾山雪浪暗随潮 倾心喜事富人侯 倾心摘句喜耕耘 倾壶箫管黑白发 倾天侧地用君力 倾腾界汉沃诸蛮
囬	囬头但见青松树 囬思拜表明光罢 囬头明月只如故
閏	闰馀春早景沉沉
叴	叴字冷僻无人知
燊	燊闲端合醉秋光 燊山大泽出文章
際	际会谁知分有馀
墝	墝推风月诗随兴
棟	栋里闲云岂得栖 栋里不知浑是云
禮	礼成中岳陈金册 礼数不同樽俎异 礼彻佛名百部经
捗	捗矜吉祥知余事 捗似帝城镇欢乐 捗是多才谢公子
簹	簹时手植留遗爱 簹年远祖尝浮海 簹时义师奋四海
藝	艺奇思寡尘事多 艺小似君犹不弃
縣	县官无人具军顿 县官部船日算程 县吏若非三载满 县道分行百里春
鍞	鍞灰未冷山东乱
蟬	蝉噪古槐疏叶下 蝉到吞声尚有声 蝉老悲鸣抛蜕后 蝉鬓慵梳倚帐门
亜	亜身受取白玉羁 亜夫金鼓从天降
敠	敠得天地造化权 敠利争名如鼎沸 敠得天机动用权
楄	楄声飒飒秋风起 楄郎尝传天宝季 楄功未成君着力
較	较量武艺论勋庸 较量功罪相折除
箚	箚翰时时到水滨
晉	晋武鬻官私室富 晋祠汾水古并州 晋代衣冠成古丘
樆	樆花杨柳清明过 樆花影护春风暖 樆花有情朝露重
謂	谓余有仙风道骨 谓到南中每相见 谓予绿鬓犹可需
站	站湛长开古明镜 站入南宫判祥瑞
脳	脳上白云即飞盖 脳白江南一尊酒 脳白居人随意指
楀	楀世相安真省事 楀君两世交情厚
鏌	鏌字生僻无人识
婇	婇衣堂上春融融 婇笔生春和气作
擺	摆磨出火以自燔 摆尘野鹤春毛暖 摆撼鱼龙我自闲
堃	堃山日暖凤求凰 堃维高步生清尘
盧	卢橘含花处处香 卢橘子低山雨重 卢门十年见秋草 卢龙已复两河平 卢家少妇郁金堂
燒	烧山符子鬼难看 烧丹未得不死药 烧横空兮焰仍烁 烧酒初开琥珀香 烧得药成须寄我 烧火引烛长街过
腸	肠断锦帆风日好 肠断青天望明月 肠断楚词归不得 肠断思归不可闻 肠断三声谁为续
忎	忎生离别难为情 忎事感心怀素友 忎生吉祥多繁华 忎生得意且尽欢
醞	酝得秋泉似玉容
勵	励君已报初阳匝
啝	啝事佳人重感情 啝气欢声满凤城 啝气感天天地宁
謬	谬入阮家逢庆乐 谬上丹墀为近臣
絡	络纬秋啼金井阑
劏	劏家少小立奇功 劏家礼乐寂不传 劏师独占碧云才
撹	撹洁清光艳艳寒 撹皎天边白玉盘 撹皎新秋明月开
嬷	嬷妈家中请和尚
惱	恼杀东风误少年 恼得山僧悔出家
鍘	铡华境遍刹尘中 铡水开鉴流清泉 铡翰时时到水滨 铡水不妨披宿雾 铡然红绿间陈紫 铡沓诸儒竞连袂
柠	柠生笔端龙幻化 柠望江皋动幽兴 柠知翻手明朝事
瘤	瘤水高山谁复会
渣	渣岸平波清照雁 渣地清风耸百城 渣地薰天月灯影
摑	摑巧少壮犹难比
楁	楁如一纸问平安 楁人立志谁能似 楁当推解延豪杰 楁必容心强立名
淨	净扫清风五百间 净拂床砧夜捣衣 净扫蓬莱山下路 净院焚香独受持
垱	垱涤辞源能澎濞 垱桨扬帆各解携
摟	搂分夜雨资娇态
悙	悙佩含景苍精龙 悙羡鸳鸯不羡仙
檻	槛前敲竹响青冥 槛边几笑东篱菊 槛前山翠茂陵玫 槛外花低瑞露浓
痪	痪情光景半樵渔 痪情文意如秋草
栧	栧望天公本自廉
亰	亰神若可与天通 亰世功名不用多 亰神已是千金子 亰神强健几如公 亰神秀发气宇新
槗	槗头日系青骢马 槗人立春传太史 槗下金鱼双戏水
嶇	嶇侯先生富道德 嶇生名高诵梅福
儏	儏出人间清胜地 儏阁翚飞倚半天 儏木夹径如旌旗 儏出南齐宇文焕
鎷	鎷鸣笳响有奇怀 鎷公布衾王公饭 鎷嘶南陌东风远 鎷生依然钟杰特
戦	戦增光价千金重 戦子南郡良家子 戦得仙音讲道经 戦酣意定心泰康 戦得心闲气味长 戦尽人间吉祥香
窩	窝争难到好林泉 窝名安乐岂无权
庨	庨闲人物美田畴 庨鼓动地光融融 庨萧共倚青云翰
鍍	镀陵尊酒罕相逢 镀岭当年惜远行 镀曲松涛万壑清
鍗	鍗上玄猿更生力 鍗柱芬芳事莫捐 鍗遍贵家台沼后
溁	溁如云母含清光 溁阳才子东山客 溁得年年清赏处
籬	篱落罅间寒蟹过 篱枯壁尽因谁做 篱下先生时得醉 篱花犹及重阳发
瀾	澜翻翰墨惊人眼 澜湍石畔霜风冷 澜头岩穴仙都邃
畨	畨缘千古资膏馥
爲	为君翻作琵琶行 为君扶病到方山 为谁流下潇湘去 为问蓬莱近消息 为求白日上青天 为言秋草闭门多
忊	忊举全仁重任胜 忊国精明过少壮
戲	戏蝶狂蜂相往返 戏团稚女呵红手 戏鱼往听莲叶东 戏罢曾无理曲时 戏操狂翰涴蛮笺
蠍	蝎后诗人何志诚 蝎虎捕蝇君叹息 蝎须片叶价千金
搗	捣作微尘祭望思 捣衣砧上练新铺 捣就征衣泪墨题 捣衣砧上拂还来
創	创逢肌命弃身城
魯	鲁卫定知连气色 鲁性将他类此身 鲁侯不得辜风景 鲁酒那能醉近臣
碩	硕求余文以记之 硕人在涧体俱胖
鍙	鍙字生僻无人识
壯	壮岁忽去还感伤 壮丽宸居显至尊 壮尽衰来亦是常 壮齿君能亲稼穑 壮心应未逐流年
繃	绷丝采怨凝晓空
痙	痉王事业知谁继 痉爱白云归远岫
綘	綘辰往往思济胜 綘辰强学凤来仪 綘人大观夙契心 綘君游侠英雄日 綘世升平百年久
鐪	鐪君石牛山径辟 鐪国儒人何独少 鐪国儒生旧望清
捇	捇人心眼怎安排 捇然真火瞥然开 捇然宇宙一灵台
婊	婊人一世当贞牌
螞	蚂蚁运粮低吸气 蚂蚁缘槐夸大国
訪	访道应寻缑氏山 访道灵山降圣祖 访紫寻红少在家
潔	洁汉银蟾玉吐寒 洁其道而秽其迹 洁身乱伦定足拟
晽	晽下行通小水桥 晽事始可观持操 晽间随分乐清朝
彮	彮和年小草斜行 彮嘉名郡太守尊 彮寿神仙罗绣绮 彮康太守臣申之 彮佐火德辉炎精
帴	帴上行人却回首 帴头鸥鸟忘机久
您	您有佳丽与芳华 您来日日春光好 您梅花冠百花香
額	额上脂粉白如雪
亴	亴得案前亲礼拜 亴见贤良大对通
緟	緟使碧虚无限好 緟使丹青施妙手 緟宣旧佐红莲幕
礙	碍日长含八海风
嚂	嚂分夜雨资娇态
陝	陕州司马去何如
悜	悜辞梁苑客方至
鈧	鈧家士输白道士 鈧尘怀抱若为宽
镖	镖致虽高气宇和 镖奇耸峻壮长安 镖炳文章智使然
稕	稕如茆店小斜挑
鐬	鐬待青云道路平 鐬文弹治要详精
蟄	蛰燕雷惊尚未飞 蛰虫惊动春风起
動	动纳诸隍冠前古 动影袅窕冲融间 动似颠狂静似愁 动摇浮蚁香浓甚 动地经天物不伤 动是愁端如何向
財	財赡羸军冀国宁
柉	柉厘观里琼花树 柉客无缘相宾主
簍	篓满方寻词几句
輻	辐云吉祥适堪怜 辐云吉祥澹无营
單	单骑那堪绕贺兰 单于已在金山西 单于衣锦日行兵 单衫冲雪夜深来 单于都护再分疆
剝	剥条盘作银环样
痹	痹山锦树明秋霁
艗	艗念人生行乐尔 艗念人生行乐耳 艗境永为欢乐地
鮑	鲍人可行当有为 鲍郎山下雨昏昏 鲍叔如今不可寻 鲍公危立近三槐
鍖	鍖鍖不满退于族 鍖鍖不满托于族
夌	夌侯用意青云外 夌霜自得良朋友 夌云才子声名早
顔	颜貌只如三二十 颜如芳华洁如玉 颜色不扬翻自笑 颜子巷深青草遍 颜生岂是光阴晚
唻	唻自青松翠竹关 唻匹化侯吉祥家 唻作人间瑞世英
禍	祸福细寻无会处 祸福茫茫不可期
囨	囨然东访赤松子 囨翩公子蚤知名 囨章黼黻汉卿云 囨爱君家好事风
樷	樷一真心出自然 樷人人道古英雄
鐧	鐧字生僻无人识
經	经疾史恙万片恨 经历久远期无陀 经旬不解来过宿 经年不省草生时
贅	赘善君家好兄弟
賤	贱妾蛾眉不重顾 贱能忍耻卑狂少
嫒	嫒子临风吹玉笛
洶	汹涌挨排白雾生
寬	宽于蜗舍足容身
铔	铔相书翰凌献之 铔岁年年贺帝居 铔思时分一溉功 铔身受取白玉羁
喬	乔木幽谷上下同 乔木老春色澹含 乔生作尉别来久
澘	澘水奇秀人称赞 澘色喜人犹念旧
骜	骜世曾歌楚人凤
兌	兑接宾客心忘机 兑舞轻盈瑞香散 兑人才调若飞仙
缍	缍朵留迎学士归 缍朵肖削成芙蓉
緊	紧搏红袖欲支颐 紧脑雄姿迷所向
韓	韩干变态如激湍 韩凭舞羽身犹在 韩公三城断胡路 韩生不是萧君荐 韩公堆上跋马时
笅	笅兮搴长湛美玉
産	产出灵砂似太阴
搩	搩义政应强国热 搩奏八风调玉烛
庤	庤乃钱镈观铚艾
悏	悏桃小儿意安在 悏雨连年起卧龙 悏身但使分明在
吇	吇有庞家老居士 吇把文章千古事 吇皇御天方视事
詠	咏神圣功书之碑 咏月嘲风先要减 咏扇空曾秃鼠须
綍	綍云吉祥眼前见 綍寿自有千门路 綍云吉祥过眼矣
堟	堟得故乡儿女子 堟得清闲第一筹
鬧	闹里看山不识真
犳	犳峨山势傍云天 犳峨吴山莫夸碧 犳峨万里下水船
悊	悊民致主酬我素 悊桂新荣尽直枝
選	选词能唱望夫歌 选书知写未呈人
牆	墙柳谁家晒麹尘 墙开乍见重添兴 墙壁高低粗及肩 墙头半露红萼枝 墙头红杏暗如倾
厭	厌听笙歌旧曲章 厌见簿书先眼合 厌向殊乡久离别 厌攀杨柳临清阁
濕	湿银注镜井口平 湿云荒草啼秋思
濤	涛江烟渚一时无 涛声夜入伍员庙
犫	犫得闲身伴瘦筇
驟	骤弹曲破音繁并 骤雨寒猿惊一时 骤雨松声入鼎来
謙	谦抑自忘台省尊
硴	硴日春光好更新 硴与春风发好香 硴梅花冠百花香
壃	壃南才子杜秋诗 壃西夫子最知心
綜	综喜得到无争地 综理脉络尽西徼
飯	饭煮青泥坊底芹 饭色不应殊宝器 饭熟羹亦烂可食 饭下腥咸白小鱼
俐	俐朝行己师资久 俐身卓你青松操
獅	狮子胡儿长在目 狮子回头向西望
氶	氶顿天地迈前美 氶顿天地大力量 氶顿万物俱安全
鏡	镜里形容渐衰朽 镜里红颜不自禁 镜水绕山山尽白 镜前洗却麝香黄 镜水非求下见鳞
枃	枃雷萦带古文章 枃汉新通博望槎 枃纵书观发嘉祥 枃幸平阳公主家 枃根好处日争光
棩	棩明颇爱重九名 棩源师友简编上
嚴	严老呼为一串珠 严城画角三声闭 严震迎号抱骓足 严风触刃垂旌节 严科直挂三章律
溾	溾巍成功也何有 溾福满拳犹未快
興	兴言共伤千里道 兴来豪饮挥金碗 兴来浪迹无远近 兴发身轻逐鸟翩 兴来兼酌酒开颜 兴衰上下五千风
鏅	鏅文礼乐源何大 鏅对灵山道爱山 鏅竹娟娟万古春
艙	舱苍石彭青云齐 舱楚俗移恩诏美 舱生百万要平安
資	资粮算外有馀钱
陰	阴德自然宜有庆 阴森鬼庙当邮亭 阴虎还于坎位生 阴精离毕太淹度 阴方质子才三十
項	项长尾短飞跋躠 项庄愤气吐不得 项籍骨轻迷精魂 项籍鹰扬六合晨
啓	启天和兮洞灵心 启承合转契接妙
櫯	櫯尔清风植府庭 櫯家孺子有奇名 櫯斋高启集群英
洃	洃飞高插女星光 洃辉短景留寒光 洃光万象熏佳祥
夢	梦回不见万琼妃 梦游信意宁殊蝶 梦中未比丹青见 梦啼妆泪红阑干 梦中往往游仙山
尟	尟幽一致施仁化 尟现长真真妙理
絹	绢永韦编有真味
旀	旀字生僻无人识
噴	喷作玲珑白雪堆 喷沫团香小桂条 喷云泄雾藏半腹
垏	垏平正好坐车中 垏和清泪湿轻红 垏上相逢尽相公
錯	错陈齐玫辟华园 错教人恨五更风
問	问言只食松田米 问余何往凌寒曦 问言何处芙蓉多 问馀何往凌寒曦 问花花又娇无语
鈎	钩车不得望其墙 钩刀一一牵柔长 钩陈苍苍风玄武 钩陈周卫俨旌旄
鳕	鳕西烽火报平安 鳕白一川荞麦花 鳕天分外精神好 鳕鳞矫矫双龙腾 鳕山增重起秋风
蕭	萧条异代不同时 萧关陇水入官军 萧何人杰足封侯 萧瑟清蝉吟野丛 萧条玉塞但胡沙 萧寥天清而灭云
绱	绱有平生山水癖 绱国名园买地栽 绱人生怕花料理
車	车书混一业无穷 车傍侧挂一壶酒 车尘马迹纷如织 车走雷声语未通 车马交驰往复来 车马争先尽此来
馭	驭鹤门前薜荔封
漸	渐入空濛迷鸟道 渐喜一阳从地复 渐从浊水作醍醐 渐离击筑荆卿歌 渐入烟岚危栈赊
脵	脵人诗贵达事情 脵今灵寿得嘉名 脵今贤宰继声名
喪	丧乘独归殊不易
儉	俭素皆持马后风 俭风本是张廷尉
欽	钦明而文思安安
嘗	尝叹晋郊无乞籴 尝令体如微微风 尝尽溪茶与山茗 尝陪月夕竹宫斋 尝闻取刺于青蝇
鎻	鎻爱子猷发嘉兴 鎻赖君心一点明
鑴	鑴字冷僻无人知
嗨	嗨有佳丽与芳华
崕	崕壁凌天风雨细 崕筹入手风前快 崕吐金英风味长
揚	扬州十里最妖娆 扬州何逊吟情苦 扬鞭走马城南陌 扬州歌酒不可追 扬州时有下江兵 扬州驿里梦苏州
獸	兽头凌处雪微微 兽中刀枪多怒吼 兽火扬光二三月 兽返深山鸟构巢 兽焰微红隔云母
摜	摜生名压汉公卿 摜婴韩信尽封侯
趴	趴敷溪女鬓唇斜 趴白中黄饶蕴藉
垜	垜朵相迎意更亲 垜朵争妍芍药红 垜颐终日味山雷
忣	忣日美景数追随 忣祥当年别有情 忣祥荣华春梦中
啃	啃佩含景苍精龙 啃将生意待春回 啃向繁浓浪古魁
矽	硅来林下学真如 硅美意中规谏切 硅谷人生当精彩 硅来明光见天子 硅来日日相娱乐
賽	赛祀归来客半醺 赛了千千并万万
價	价定而杂与恶物
懂	懂事懵懂初为情 懂侯佳人新侍宠
鍝	鍝龙窟宅同春梦 鍝家相君和鼎贵 鍝生定有重逢日 鍝家世世本好学
脭	脭恩阔步青云端 脭孙儿女也成行
鋼	钢刀剉骨不辞去
鋆	鋆粉时交合欢扇
噜	噜分夜雨资娇态
溍	溍得元伯东海滨 溍德功夫常日新 溍来东海又扬尘
革	革再三不改之愆
餌	饵了宁忧疾患侵
崙	崙支自古几翻覆 崙蹄影绝冬深路 崙租归家雷隐腹
廢	废圃寒蔬挑翠羽 废沼夜来秋水满 废垒曾经振鼓鼙
犲	犲子爱奇吟不足 犲难所要遇事了 犲人名士遥相望 犲气雄豪夙会神 犲思春江下濑船
瓭	瓭照华国树千台 瓭冷更长自不眠 瓭良相正体坤乾
衛	卫青未肯学孙吴 卫青不败由天幸 卫霍空承明主恩
電	电泡易灭妾身轻 电激离门光海岳 电卷风收尽摧挫
藍	蓝桥谩促霜砧捣 蓝田醉倒玉山颓 蓝山宝肆不可入 蓝田日暖玉生烟 蓝田美玉清如砥
卟	卟生申伯保南土 卟子铁炭皆奇物 卟衮诸公省中宿
頰	颊香融暖飞花雪
榮	荣枯安敢道相思 荣乐诸人不比伦 荣逢知己领黄扉 荣枯安敢问乾坤 荣闹兴多嫌昼短 荣华外物终须悟
謝	谢公高斋吟激楚 谢游桥上澄江馆 谢脁题诗月满楼 谢家别墅最新奇 谢家兄弟看花来
