
        [console_scripts]
        psamm-model = psamm.command:main
        psamm-sbml-model = psamm.command:main_sbml
        psamm-list-lpsolvers = psamm.lpsolver.generic:list_solvers
        psamm-import = psamm.importer:main
        psamm-import-bigg = psamm.importer:main_bigg

        [psamm.commands]
        chargecheck = psamm.commands.chargecheck:ChargeBalanceCommand
        console = psamm.commands.console:ConsoleCommand
        dupcheck = psamm.commands.duplicatescheck:DuplicatesCheck
        excelexport = psamm.commands.excelexport:ExcelExportCommand
        fastgapfill = psamm.commands.fastgapfill:FastGapFillCommand
        fba = psamm.commands.fba:FluxBalanceCommand
        fluxcheck = psamm.commands.fluxcheck:FluxConsistencyCommand
        fluxcoupling = psamm.commands.fluxcoupling:FluxCouplingCommand
        formulacheck = psamm.commands.formulacheck:FormulaBalanceCommand
        fva = psamm.commands.fva:FluxVariabilityCommand
        gapcheck = psamm.commands.gapcheck:GapCheckCommand
        gapfill = psamm.commands.gapfill:GapFillCommand
        genedelete = psamm.commands.genedelete:GeneDeletionCommand
        gimme = psamm.commands.gimme:GimmeCommand
        masscheck = psamm.commands.masscheck:MassConsistencyCommand
        primarypairs = psamm.commands.primarypairs:PrimaryPairsCommand
        randomsparse = psamm.commands.randomsparse:RandomSparseNetworkCommand
        robustness = psamm.commands.robustness:RobustnessCommand
        sbmlexport = psamm.commands.sbmlexport:SBMLExport
        search = psamm.commands.search:SearchCommand
        tableexport = psamm.commands.tableexport:ExportTableCommand
        psammotate = psamm.commands.psammotate:PsammotateCommand
        modelmapping = psamm.commands.model_mapping:ModelMappingCommand
        vis = psamm.commands.vis:VisualizationCommand
        tmfa = psamm.commands.tmfa:TMFACommand

        [psamm.importer]
        JSON = psamm.importers.cobrajson:Importer
        SBML = psamm.importers.sbml:NonstrictImporter
        SBML-strict = psamm.importers.sbml:StrictImporter
        MATLAB = psamm.importers.matlab:Importer
    