[asreview.datasets]
builtin = asreview.datasets:BuiltinDataGroup

[asreview.entry_points]
algorithms = asreview.entry_points:AlgorithmsEntryPoint
lab = asreview.entry_points:LABEntryPoint
oracle = asreview.entry_points:OracleEntryPoint
simulate = asreview.entry_points:SimulateEntryPoint
simulate-batch = asreview.entry_points:BatchEntryPoint
web_run_model = asreview.entry_points:WebRunModelEntryPoint

[asreview.models.balance]
double = asreview.models.balance:DoubleBalance
simple = asreview.models.balance:SimpleBalance
triple = asreview.models.balance:TripleBalance
undersample = asreview.models.balance:UndersampleBalance

[asreview.models.classifiers]
logistic = asreview.models.classifiers:LogisticClassifier
lstm-base = asreview.models.classifiers:LSTMBaseClassifier
lstm-pool = asreview.models.classifiers:LSTMPoolClassifier
nb = asreview.models.classifiers:NaiveBayesClassifier
nn-2-layer = asreview.models.classifiers:NN2LayerClassifier
rf = asreview.models.classifiers:RandomForestClassifier
svm = asreview.models.classifiers:SVMClassifier

[asreview.models.feature_extraction]
doc2vec = asreview.models.feature_extraction:Doc2Vec
embedding-idf = asreview.models.feature_extraction:EmbeddingIdf
embedding-lstm = asreview.models.feature_extraction:EmbeddingLSTM
sbert = asreview.models.feature_extraction:SBERT
tfidf = asreview.models.feature_extraction:Tfidf

[asreview.models.query]
cluster = asreview.models.query.cluster:ClusterQuery
max = asreview.models.query.max:MaxQuery
random = asreview.models.query.random:RandomQuery
uncertainty = asreview.models.query.uncertainty:UncertaintyQuery

[asreview.readers]
.csv = asreview.io.csv_reader:read_csv
.ris = asreview.io.ris_reader:read_ris
.txt = asreview.io.ris_reader:read_ris
.xlsx = asreview.io.excel_reader:read_excel
.xml = asreview.io.pubmed_xml_reader:read_pubmed_xml

[console_scripts]
asreview = asreview.__main__:main

